Joseph V - Shell (Original Mix)
Hoxton Whores - Love Acid
Karlos Cheadle - Crank It (Original Mix)
Jhonatan Moraes - Swagg (Original Mix)
Zenker, Harada - Rubbel Die Katz (Original Mix)
Daniel Orpi - Cosmonaut (Raffa FL Remix)
Liquefied - Jump And Shout
Larry Cadge - Vivians Kiss (Original Mix)
Aumrec - Mologolo (Doctor Trash Remix)
Stanny Abram - Manitou (Original Mix)
Spider from Majorkings - House Calling
Kevin Hart Is Terrified of Robert Irwin's Animals
Paolo Solo - Desire (Original Mix)
Shaman (Original Mix)
Matt Mclarrie - Humble Abode
Jowe X - Midnight Train (Original Mix)
Manu Fuentes - Welcome To The Club (Original Mix)
Enrico BSJ Ferrari - Anytime (Original Mix)
David West -The Hideout versus Ramon Tapia ft. Neka -Tanzgefühl [Remix]
Vangelis Kostoxenakis - Sweat (Original Mix)
Oli Furness - Crash Gordon (Bodyjack Remix)
I Want to Feel It (Linus K & Mark Mansion Remix)
Musically
Seph Martin - All Night (Original Mix)
Carl Orff - O Fortuna ~ Carmina Burana
Iburi (Original Mix)
Luke Stanger - Acid House (Original Mix)
Alan Fraze - Oxygen (Original Mix)
Carlos Francisco - Panela (Original Mix)
Delgado & Darren Fletcher - Fractured (Original Mix)
Harry Romero - The Get Down (Extended Mix)
Gary Willis - Raise (Original Mix)
Notize - Sip
With You (Extended Mix)
Seph Martin - I Got Something (Original Mix)
Kaiserdisco - Devon (Original Mix)
Catz 'N Dogz, Green Velvet - Keep On
B Gutierrez - Crash (Original Mix)
Darlyn Vlys - The End
Ipanema (Original Mix)
The Deepshakerz - Never Get Enough
Johan S - Drop It (Original Mix)
Matt North - Tobago (Original Mix)
DoubleTouch - Feel It (Massimo Lippoli Remix)
Luna City Express - Gloria (Supernova Remix)
Pakhi Dogs - Mohican (Original Mix)
DJ Haus - Ready 2 Jack
Funky & High (Jesus Nava Remix)
Alberto Tolo - The House Nation (Original Mix)
Dempsey Massy - Jungle (Original Mix)
Vangelis Kostoxenakis - Crazy (Joeski Remix)
Fly Song (Max Chapman Extended Remix)
DJ Anna, Beverley Ely - Secret (Club Dub)
Renga Weh - Prelude (Original Mix)
Yeray Sanfiel - Fanfarreando (Miguel Bastida Crowd Dub Remix)
Spacid
Lee Foss, Latmun, SPNCR - Dusk Til Dawn
Andy Peimbert, MarcoA. - Safe Dance (Original Mix)
Linkin Park - In The End (Mellen Gi & Tommee Profitt Remix)
Joy Marquez & D Fake   Indian Soul RIVIERA UNDERGROUND
Roberto Surace - Wishes (Original Mix) TR090
Dan Rubell - Unthinkable
Seb Zito - Got That Vibe
Neil Parkes - Escape (Original Mix)
Berlak - Petit et Grand (Original Mix)
Chris Carrier - Last Minute
Richard Malcoh - Buildings & Love Part 2 (Angelo Ferreri Remix)
Uhh Ahh (Gruuve Remix)
Danny Garlick - Open Your Mind
Don't Believe (Original Mix)
Jamie Jones, Nathan Barato - Cherry's Revenge (Original Mix)
Crazy Frog - Axel F (Official Video)
Mashkov - Street Fighter (Original Mix)
The Conga (Original Mix)
R.E.M. - Losing My Religion (Official Music Video)
DJ Wady, Dvit Bousa, Rio Dela Duna - Revolution (Original Mix)
Genghis Clan - In the Club (Original Mix)
Rich Pinder - Don't Want You (Electronic Youth Remix)
Reachin' (Original Mix)
Andre Butano - Friendship
Mike Gloria - Skywalker (Original Mix)
Reza, Barry Obzee - Tek Ya Body (Original Mix)
Gregor Tresher - Frontline (Nic Fanciulli Remix ) (Ajax Pontéh Vocal Edit).
Mix & Master (Dub Remix)
Reboot - Beating Bud
Sven Tasnadi - Make It Right (Dario D'Attis Remix)
Ruben Zurita - Ganja (Original Mix)
Iva Dive, Tuff Dub - Disco Tech (Original Mix)
Dark Beat - Ritual EP Inc Remixes L_cio, Boghosian
The BeatThiefs - Umbungo (Chocolate Puma Remix)
Mario Larrea - Shake (DJ Boris Remix)
Curtains for You (feat. Roxy)
Ben Sterling - Ciao
Martin Badder - So Sure (Original Mix)
Mike Mac - Get The Fuck Up (Ordonez Remix)
Julien Sandre - You Know (Orginal)
Julien Fuentes - You See I Am (Original Mix)
Baewatch
Mitch de Klein - Drum (Extended Mix)
Dj Csemak - Old School Hands (Original Mix)
Alex Gomez & Jesse Strada - Bola Palito Bola (Rafa Alcantara Remix)
Billy Da Kid - In My Arms (Sammy Porter Remix)
ULTRA 2018 AFTER HOURS TECH HOUSE MIX
RanchaTek, DurtySoxxx - Fuckin' Crazy (Original Mix)
George Michael - Careless Whisper (Official Video)
Ginger Shinobi - You Are (Original Mix)
Rulers Of The Deep - Last Survivor (Album Version)
Pasquale Caracciolo - Paradise
Uch - Genius Of House (Remixes)
Gianluca Caldarelli - Speechless (Original Mix)
Latency - In Your Head (S. Jay & Ostertag Remix)
Marco Berto - The Way (Vocal Mix)
A1 Bassline - T Moe P
AR38 - Thanks For That (Original Mix)
Free the World
Ali Ghanavi - Rain Dance (Original Mix)
Prok & Fitch & Marco Lys - You Need Some (Original Mix)
Sonic Future - Do It (Original Mix) [Suara]
Latmun & Iglesias - Rockin'
Diviners - Savannah (feat. Philly K) [NCS Release]
INCLINIQUE - Sunwaves (Original Mix)
Eskuche - Believe (Extended Mix)
Spider from Majorkings   Delicious by Spider Undercool
Fabier - Chicago (Original Mix)
Hollen - Tone & Color (Original Mix)
Desidia (Reboot Remix)
Shermanology - Boyz N Da Club (Original Mix)
Citizenn - Control
K-Hole (Original Mix)
Alex Maxwell - We Are Music (Original Mix)
Rishi K. - All The Ways (Original Mix)
Gorge & Markus Homm, Gorge, Markus Homm - Dizz-Co (Original)
Barry Obzee - Freakin It (Original Mix)
Toyboy & Robin - Mattress Bounce (Original Mix)
Hansol - Parabolic
Pemax - Renegade School (Charles Ramirez Remix)
Travis Emmons - Intergalactic Human Beings (Original Mix)
Doneyck, Bassoa - Like (Original Mix)
Matteo Costa - Freakin
Alex Raider, Joe Lukketti - What You Do (Stelmarya Remix)
Mister Monj - Frequency (Original Mix)
Anton Pieete - Loner (Kabale Und Liebe Keeps You Company Mix)
Murk - Dark Beat (Addicted To Drums) Feat. Oba Frank Lords (Danny Daze Fundamental Remix)
Baila Con Mi (Original Mix)
Simon Mattson - My House (Original Mix)
Rich Wakley - The Wolf Of Old Street (Original Mix)
Hira - This Is A Housebreak (Original Mix)
Will Monotone - Dem Mai Hoes
Matt Wheeler - Having Problems (Original)
Ho Do Ri - Elotrans (Original Mix)
Harry Romero - Anafogue
Joc House - Shades (An-Beat Remix)
The Deepshakerz - Walk In The Sky (Original Mix)
Leonardo Gonnelli - Meet My GF (Original Mix)
Mike Vale - Changin' (Original Mix)
Lupe Fuentes - Dancing (Original Mix)
Ljubezen (Original Mix)
John Stevens - Personal Conjecture (Original Mix)
Hunter Reid - My Bad
Tony To Van - Fairy (Original Mix)
Tokyo Sindrome - Fire (Original Mix)
Tlou - Child of God (Daniel Ray Remix)
Kormak - Feel (Extended Mix)
Gabriel Horner - Get Back (Original Mix)
Leonardo Gonnelli - Tonada (Original Mix)
Van Bellen - Let Me Take You (On a Journey) (Guy Mantzur & Roy Rosenfeld Remix)
Greenwolve - For Tomorrow (Original Mix)
Khainz - Ice
Noxious (Fab Massimo Remix)
Mele - The 95 Vibe
Javi Bosch - Nena
Dee Marcus - Cutoff (Original Mix)
Azteca - Trip To Oz (Original Mix)
House Divine - Tell Me (Tim Le Funk Remix)
House4Pleasure - Get It (Original Mix)
Full Intention - Automatic
Duky - Thinking About You (Chris Lattner Remix)
Joeski - Mind Body & Soul (Original Mix)
Javi Bora - The Old Terrace (Original Mix)
James Burton - On Yer Own (Original Mix)
Jack G, Jess Cee - You Are The One (feat. Jess Cee) (Richard Ulh Remix)
Ellroy - Inferno
Nick Curly - Rack and Run (Original)
Sosa (UK) - Warp Speed (Original Mix) [HOTTRAX]
Lennox Greenfield - Ibiza Drums
Breaking Toys - High Sense (Original Mix)
Mancodex - Freak Out (Original Mix)
Fer Br - The Drummer
Kenny Ground - Bad Habit (Francesco Dinoia Remix) [OSD004]
Ben Champell   Walk Main Mix
Binny - Life (Original Mix)
Jesse Perez - Still Slangin' That D (Original Mix)
Andre Butano & Odd People - Hotel 99
Lee Garrett - Haunting (Original)
Todd Osborn - Beat A
Benno Blome - Abotha (Mihai Popoviciu Remix)
Mikee (Athens) - Wrong House (Original mix)
Commotion
Huxley - Who Sez (Extended Mix)
Ron Flatter & Ole Biege - Salamanca - PLV022
FreedomB - Twister (Davina Moss Extended Remix)
Jay de Lys - Yo Hanzz Up (Original Mix)
Riva Starr, Green Velvet - Keep Pushin' (Harder) (Original Mix)
Taster Peter - Hang Out (Original Mix)
Ekoboy - Happy Dance (Original Mix)
Will Clarke - Hip Hop Power (Original Mix)
MISHQA - Dance It
Oscar G - What You Need feat. Tamara Wallace
J. Worra - So Excited (Extended Mix)
Fade (Fatima & Jerome Interpretation)
Jochem Hamerling - Cabana Fresca
Jay De Lys & Jamie Roy - Savorlatino (Extended Mix)
The Sahoo Conection - Deeper Love (Original Mix)
Joeski - Champion Sound (Boombastick Mix)
Sable Sheep - Upon Burning Skies
Josh Butler - Tracks
Will Easton - 18 Month Free Trial (Original Mix)
Carlos Torre - Old School (Original Mix)
Apollo 84 - The Walker (Original Mix)
Matteo Floris - Hand Slappin' (Original Mix)
KC Lights - SOL (Extended Mix)
Arthur Hernan - Mexican Groove
Sonny Fodera, Gene Farris - We Work It (Original Mix)
Jame Starck - Lift Me (Original Mix)
Pianopop (Original Mix)
Musical Minds (Original Mix)
Hector Bello - Different Way (Original Mix)
Luuk van Dijk - Seduction
ItaloBros - Spacey
David Duriez - The Trouble I've Been Known For (Kike Henriquez Remix)
Manuel De La Mare - Very Bitch (Olivier Giacomotto Remix)
Rossko - The Step Up
dotSTRIPE - Good Inside (Original Mix)
Giants - Tryna Chill (Original Mix)
Nico Stojan - Ginkhoe (Original Mix)
Danny Murphy - Resurrection (Original Mix)
[SDA029] Scientific Funk - Acid Killer (Original Mix) [Something Different Again]
PAWSA, Wade - Anahata (Original Mix)
GotSome, The Get Along Gang - Bassline (Chus & Ceballos Stereo Remix)
Nestor Sanchez - Is Back
Brett Gould - All of a Sudden (Original Mix)
Eskuche, Nu Sky - Work that (Rene Amesz remix)
Sovax - So Close (Original Mix)
Steve Angello & Laidback Luke feat. Robin S - Show Me Love (Mike Prob Remix)
Dany Cohiba - Rastafari (Kingstom Version)
Kikka Vara - Be
Boss Axis - Down Home (Original mix)
Kocleo - And On (Original Mix)
B-Ju - Merianplatz
Andres Pesqueira - Sunday Mood (Piem Remix)
David Glass - All Aboard
D'JAMENCY - Tech Clubbers Podcast #024
Delgado - Take It Down Deep Bass Sound (Original)
Vanilla Ace, Luke Davidson - Addicted (Original Mix)
Free At Last (Martin Ikin Extended Dub)
Late Replies - Highway Freedom (Extended Mix)
Francesco Parente - Don't Tell Me
Savanna Hale (Lee Jeffery Remix)
Michael Deep - Bottom (Original)
Metodi Hristov - Join The Meeting (Original Mix)
Sax Pleasure (Souldynamic Remix)
Loco Dice - Detox (Original Mix)
Ekkohaus - Going Nowhere (Marcos in Dub Remix)
Danny Serrano, Mendo, Andre Butano - Ramon Ramon (Original Mix)
Junior Sanchez - Da House Dat Jack Built
Stanny Abram - Sango Yakoma (Original Mix)
3Kilo - Space Lopez (Original Mix)
Mene - Juice (Original Mix)
Dateless - Spiritual Warfare (Original Mix)
Lee Pearce - Back To Basics
Sirus Hood - Love (Original Mix)
Albert Marzinotto - Paris (The Deepshakerz Rework)
Jerome Sydenham, Sally - Black Jerusalem (Original Extended Version)
Sean Random - Lonely (Original Mix)
Denney - Check the System
Alonso Bierg - Gettin' Deeper (Extended Mix)
Oliver Koletzki feat. HVOB - Bones
Wrighty - Phsycopath Talkin (Original Mix)
Worthy - The Warning (Original Mix)
GAWP - Who Is She
Lundgren - Structures (Oliver Schories Remix)
The Mekanism - Lazy Night (Original Mix)
Stanny Abram - 2 The Top (Original Mix)
Simon Doty, DJ Dan - Disco Slice (Original Mix)
Tone Troy - Release Myself (Original Mix)
Steve Lawler - Par Amour (Chris Carrier Remix)
Gamba Roja (Dimmish Remix)
Tim Marts - People (Original Mix)
Joaco - Loco (Lumc House Remix)
Ben Colmen - Just Hit Me (Original Mix)
Demarkus Lewis - Go Train (Original Mix)
Ruben Zurita - Abstraction
The Deepshakerz - Reaction (Main Mix)
Delgado - Hold Me (Yeah Mix)
Kevin McKay, Romanthony - Freaky Dancers (PAX Remix)
I See The Light
Marco Anzalone - Right Now (Original Mix)
Francesco Dinoia - Move the Beat (Extended Mix)
SABY DAVIS - LONESOME CREEK(promo release)
Late Replies - Highway Freedom EP (Extended Mix)
Julian Wassermann, H.B.C. - Funk Funk (Original Mix)
Prince Club - La Charma, Pt.2 (Prince Club Sub-Marine Mix)
Invader Alex - Acid Boots
Faulty Minds - It Doesn't Matter (Original Mix)
CocoDaSilva - Saudade (Matt Tolfrey Ec1 Mix)
Dateless - Bee
Hermanez - Powned (Original Mix)
Sonartek - Kyoto Vibe
Dan Rubell - Rumiyoc
Beatkind - Funky B (Saccao & Shake Sofa Remix)
Depth Perception - I.D.F.K.A. (Original Mix)
DeMarzo - Ojon (Original Mix)
Dj Csemak - Let it Go
Roberto Camaro - Welcome To The Future (Robbie Rivera & Benny Camaro Edit)
Mason Maynard - McLovin' (Original Mix)
Niceguy Soulman - Feel It (Oliver Schmitz & Micah Sherman)
Glen Coombs - Wax On Wax (Original Mix)
Danny Bimbela - Novara (Original Mix)
HAYNES - Nasty Girl
Ray MD - The Best Party (Original Mix)
De Fantastiske To - Hardtslående (Alinka Remix)
Alaia & Gallo - Okay (Original Mix)
Veltron, Wolf Jay - Everbody
D'Julz - Serendipity (Sebo K Remix)
Titan Road - Motion (Original Mix)
MidKnightz - Found My Home
Max Brhon - Cyberpunk [NCS Release]
Danny Tenaglia - Don't Turn Your Back (Harry Romero Remix)
Tell Me (Original Mix)
PEACE MAKER!, First - Isolation (Extended Mix)
Piero Scratch - Easy Buddy (Extended Mix)
Arriba
Spacefunk Dub - Bayioo (Original Mix)
Aldo Cadiz - Tramdoul (Original)
Madonna - Bedtime Story (2003 Peter Rauhofer White Label Mix)
Dick Johnson - Get To You (Original Mix)
Little Fritter - Bang This Joint (Original Mix) [CATCH & RELEASE]
Danny Kotz - Tour Lumiere
ZDS - Bang
Jonathan Kaspar - Cicatrice
Mr. Lekka - Pop Stars (Original Mix)
ZDS - Be Together
Level Groove - Essence
DJ Skip - Dirty Dance (Gettoblaster Remix)
Jansons, Senzala - JNZ (Original Mix)
Michel de Hey - Smugglers Pants
KI Creighton - Acid Rain (Original Mix)
Quell (Original Mix)
Toivo - Night Ride (Original Mix)
Samuel Dan - Syron (Original Mix)
The Movement Twins - That's What Love Is (Original Mix)
Rafa Ristallo - Field Of Jack
Vloon M, Shane Fontane - Fantasy & Ecstacy (Original Mix)
Jansons, Liz Cass - Less Ordinary (Extended Mix)
Ahmet Mecnun - Low Rider (Original Mix)
PAX, Hannah Magenta - We Can Evolve (Audio Junkies Remix)
Fellar - Gimme Your Body (Original Mix)
Black Soul (Original Mix)
Afekt Music - Breakfast (Original Mix)
D.Ramirez - Control of My Soul
Apraz - Margarita (Original)
Le Brion - Eclipse (Original Mix)
Mhod - Everywhere
Gion - Stuck Inside (Original Mix)
Dakar - Get No Sleep (Original Mix)
Federico Ambrosi - Horus
Jake Beautyman - This Is a Joint
John Stoongard - Heartbeats (Qubiko Remix)
CJ Jeff, DJ KAS - In My Mustang
Dan Corco - Geared
Joss - Solely (Original Mix)
Shermanology - Pop That
Behavioral Therapy (Original Mix)
Lemonsoul Beats - Curveball (Vince Tyler Mix)
Sergio Parrado - Gonna Change (Original)
Yoga Queef - Don't Build That Wall (Original Mix)
Harry Romero - Selekta (Extended Mix)
Roland De Saint - Voyage
Dalfie - Lunar Carnival (Original Mix)
Orchestra Familiàr - Jack
Tobia - Flamingo (Original Mix)
Jimmy Switch - Dial H (Original Mix)
Mikel Curcio - Adriano (Original Mix)
Dj Dextro - 49 Ceti (Original Mix)
Ammo Avenue - The Only One (Extended Mix)
Astin, Waveshape - Lazzaro's Shoes (Original Mix)
Waifs & Strays - Heartbeat (Original Mix)
Huxley - Clunk
Ruben Mandolini - Romantica (Original Mix)
Spega - Nobody (Original Mix)
Seb Zito - Slap Dash (Original Mix)
Blvckr - Nuthin Like The Old School (Extended Mix)
Lunatike - New Ground (Original Mix)
Walter Kurtz - Vibrant
Federico Ambrosi - Underwater (Original Mix)
Double Vision IT - Bomber (Original Mix)
Atove - Panic
The Wake Up (Alexi Delano Remix)
Tat2 - Oh Yeah (Original Mix)
Premiesku - Abduction
Burning Bridges - Low Down (Original)
Per QX, Elias Bravo - Hot Head
Bryan Cox & Sergio Pardo - Get It Started (Original Mix)
Arilamas - Oversigh (Original Mix)
Jake Would - Can't Get Enough
Adam Shaw - Out Of Reach (Original Club Mix)
Camilo Do Santos - So Sexy (Original Mix)
Harry Romero - Control
Roberto Palmero - Pampala (Original Mix)
Cuando Mueves (Original Mix)
Genghis Clan - The Drum Tune (Original Mix)
Don Santiago - Artist at Work (Original Mix)
Tiger Stripes - Sisters (Tini Remix)
Stanny Abram - Make You Love Me
Christian Nielsen - Need That Something (Original Mix)
Dillon Francis - Touch (feat. BabyJake) (Jaded Remix)
Acid Mondays - Svenkins (Sneaks BBQ Beats Mix)
option4 - Back2Business
Pagtanggap - Emboy x Vertuso x Tonix (Official Lyrics Video) [Prod.Freaky Joe Beats]
Take You Down (Original Mix)
Clara Da Costa - Just (Steve Mac Dub)
Wally Lopez, Hunzed - Sa Caleta (The Deepshakerz Remix)
Joba - The Ritual (Original Mix)
Bontan - Dancing
Audio kode - Twilight Poole (Original Mix)
wAFF [Suicide Girls - La Bombonera] @ Museum 10.06.2016
Brennan Savage - Look At Me Now
Daniel Lera - Midnight Clubbers
Ty Tek - International Chugernaught (Original Mix)
Davide Mentesana - Sunday (Original Mix)
Turn Of The Life (Original Mix)
The Deepshakerz - Caipirinha (Original Mix)
Mowgl - Gordon Gekko (Original Mix)
Daft Punk - Harder, Better, Faster, Stronger (Far Out Remix)
Doo (Original Mix)
Alvaro Smart - Back To Jack (Atove Remix)
Timmy P - Vov (Original Mix)
Federico Rosa - Love Is Strong (Original Mix)
PAWSA - WE MOVE (EXTENDED MIX)
John Summit - Forgotten One
Victor Zala - Old Boy (Original Mix)
Lewis Monbarn - Dirty Sylvester (Original Mix)
Ralph C - Don't Worry (Original Mix)
El Rayo - Acid Jack (Original Mix)
Ruzmore - Dark Bird (Original Mix)
Tuccillo - Keep It Down (Original Mix)
Edu Imbernon, Los Suruba - Cederron (Original Mix)
Dan Ghenacia, Chris Carrier - Vaporized
wAFF - Panwa (Original Mix)
Nino Bua - Havoc (Original Mix)
Mirco Martini, Alessio Mosti - Studio 54
Dylan Debut - Wrong Turn
Raving George feat. Oscar And The Wolf - You're Mine (Official Music Video)
Rob Black - Dance Dance Dance (Extended Mix)
Woki Toki - Warm Rain (Original Mix) - UM Records
Freaks - The Man Who Lived Underground (Villalobos Greiner Remix One)
Lil Nas X - HOLIDAY (Official Video)
James Meid - When the Music
The Deepshakerz - Changes (Original Mix)
Ego Valente - Basic Tool
Confesser - Old Rocky (Original Mix)
Doc Martin, Jeff El Jefe - Corazon (Original Mix)
Everything (Extended Mix)
Strace - Bells
Ausem FF - Untold Beat (Original Mix)
Acid Skys - Revival 909 (Original Mix)
Stupidizko - Drop It (Original Mix)
Susy Seven - Give It Up (Original)
Alex Kennon - Touch Me (Extended Mix)
Tanit (Big Ma.Mi & Tone-on Remix Remix)
Reboot - Samson (Original Mix)
James Meid - Got Me
Vrsion - Vibration
Come Closer (Danny Slim Nu Deep Mix)
Tom Foolery - Black Label (Original Mix)
Lee Garrett - Grey Day (Original)
Claire Ripley - Malificent
Low Cut - Verdant (Original Mix)
Piero Pirupa, Ninho - El Paso De La Bruja (Original Mix)
Budai - Uhh Ahh (Daniel Orpi Remix)
Dj Disciple - Dissonant Illusion (Original)
De La Swing - Wake Up (Original Mix)
Wade - Irreversable (Original Mix)
Sidney Charles - About Jack (Original Mix)
Flashmob - Unrefined (Original Mix)
Christian Hornbostel - Twerking (Floor Twerking)
Chus & Ceballos, DJ Chus, Pablo Ceballos, Stefano Noferini - Mamasitas (Original Mix)
David Mayer - Burn feat.  NGHT DRPS (Gruuv)
Rini Shkembi - A Reason To Be (Original Mix)
Gianmarco Limenta - No Talk About (Extended Mix)
Cry Baby, Adam Collins - Bornless Ritual (Original Mix)
Nader Razdar - Felicidad (Original Mix)
Jardz - Maceo's Mantra
Cristian Viviano at Music On day show at El Patio Ibiza
James Zed - I Don't Know What It Is (Original Mix) [FREE DOWNLOAD]
Nozzleholder - Party Play (Original Mix)
Max Chapman - Work That Body (Original Mix)
JJ Mullor - Caliche
The Temple (Original Mix)
Cal Johnstone - Chronic Beat (Original Mix)
Gabriel Rosin - Wish (Original Mix) [G - MAFIA RECORDS]
84Bit - Like No One Before (Paolo Barbato Remix)
Paolo Viez - That's Right (Albert Aponte Remix)
Edward G - Mi Madre (Original Mix)
Marc Benjamin, Marcus Santoro, David Pietras, Forbid - Losing Focus (Forbid Extended Remix)
ZDS - Walk in Love (Supernova Remix)
Maurice Aymard - Into The Sun (Original Mix)
Milos Pesovic - Forever More (Extended Mix)
Bryan Shower - Kakao (Luthier Remix)
Paolo Solo - Urban Life (Original Mix)
Claptone - Heartbeat (Mat.Joe Remix)
Harry Romero - Sex (Extended Mix)
Kadenza - RAVR (Club Mix)
Yves Roch - Jack (Original Mix)
Matt Caseli - Dance 4 Me (Club Mix)
Dole & Kom - Never Enough (House Version)
James Curd, PEZNT, Nah Man - Japanese Disco (Upgrade Mix)
Matteo Floris - Snoozy (Original Mix)
Danny Garlick - Shaka Zulu (Original)
John Summit - Deep End (Extended Mix)
Cimieon - The Ritual
Loco Dice - $lammer (Original Mix)
Samuel Dan - First Connection (Secret Connection Mix)
Fhaken - Rotonda (Original Mix)
Drop It (Original Mix)
Rafael Sorol - Iko Iko (Sascha Dive Remix)
Marc Ross - Escape (Original Mix)
Lil'M, Jok - One Two Step (Original Mix)
Lupe Fuentes - Holla If Ya Hear Me (Original Mix)
Dennis Cruz, Iuliano Mambo - Dogs In Da House (Extended Mix)
Walter Kurtz - Logarithmetical
Jay de Lys - Girls All Black (Original Mix)
DjaimZ - 5am (Original)
Luciano, Jaw - 7 Directions (Dennis Ferrer Remix)
Frank Lamboy - Beat This (Original Mix)
Pako Ramirez - I Need You (Original Mix)
Mekkawy - Coffee Whiskey
Luuk van Dijk - Parallax (Original Mix)
Lubelski - Aqui (Original Mix)
Mattia Peonia - The Shore Club
Paul Orwin - Work It Harder (Club Mix)
Alex Flatner - Welcome To My Life (Markus Homm & Mihai Popoviciu Remix)
Jesse Perez - Daddy (Original Mix)
Sewas (Original Mix)
Ridney, Roland Clark - I'll Take U There
Sonny Wharton - Acid Man (Original Mix)
Frezel - Hero (Original Mix)
Hypside - Vanilla Ice Cream (Original Mix)
KODEWERK - Take Me Away (Original Mix)
Niccolo Vencedor, Dan Mckinley - 2NMNML 2013 (Original Mix)
Kenneth Graham - Ley Mordaza
Joeski - Set You Free (Original)
Steve Cox - Jaja (Original Mix)
Jason Chance, Kevin Andrews - Work the Track (Original Mix)
Acid Skys - Mind Games (Original Mix)
Lood (Lex Loofah Remix)
Shermanology - Bon Bini (Extended Mix) (Hot Creations) (Tech House)
Ben Champell - Berlin Gates (Original Mix)
Tahloula - We play House (NICe7 Remix)
Mirko Di Florio - Got Your Love (Original Mix)
Andrea Oliva - Upside Down (Original Mix)
Mirco Caruso - Snuuu (Original Mix)
Ed Is Dead, Dany Deep, Tawas - Afrika Wins (Original Mix)
Coyu, Cari Golden - Profound Pleasure
Tough Love - Give It Up (Extended Mix)
Jakarta Project - Badman Sound (Original Mix)
Andres Betancourt, Pablo Leone - Jungle Tenebris (Original Mix)
Rich NXT - Brigade (Original Mix)
Wheats - Bizzi (Original Mix)
Kike Henriquez - I Never Give Up (Original Mix)
Shivana Faction - No Troubles
Joel Fletcher, Uberjakd feat. Cris Gamble - Jetfuel (Original Mix)
Hysteric Ego - Colours (Original)
Noir - Night Walkers
Picca & Mars - Thinking Of (PIXELATE2)
Mr. Tophat - Aliens from Another Dimension
Chaim - Can't Wait To C U (Original Mix)
Josh Uwa - Skeletor (Original Mix)
CAMILO DO SANTOS - P.I.M.P. (Luca Secco & Craftkind Remix)
Saytek - Calling Out (Original Mix)
Mihalis Safras & Cj Jeff - Lab (MATERIAL)
Alvaro Vela - Essential (Original Mix)
Stanny Abram - BAD (Original Mix)
The Glitz - Turbo (Original Mix)
Max Chapman, Late Replies - Wassoulou (Original Mix)
Vintage Division - Turn Around Feat. Marck Jamz (Original Mix)
Ballistic (Original Mix)
Karl Jordan - Rollin' Deep (Original Mix)
Macs Cortella - Give It Up (Original Mix)
Matt Mclarrie - The Rave Cloak (Original Mix)
Eli Escobar - Chaka Khan (The Carry Nation Remix)
Outstrip - Galosha
PEZNT feat. Born I Music - Doin' My Thing (Main Mix)
PEZNT feat. Born I - Doin' My Thing (Re-Tide Remix)
Augusto Gagliardi - It's My House
Delaines - W.D.G.A.F (Original Mix)
Miguel Bastida - Benasty (Original Mix)
Gene Farris - Dreams (Extended Mix)
Billy Kenny - Just Came For The Music (Extended Mix)
Rochdee - Somewhere (Original Mix)
David Treble - Walk Voice (Original Mix)
Josh Billings - Perspective (M A N I K Remix)
Whey Baq - Tickly Cough (Original)
Ben Gomori - Lifetymez (Original Mix)
Manuel-M - Make You Jack (Original Mix)
Emiliano Martini - Hornpipe (Original Mix)
DJ Dove - Nama (Extended Mix)
Jonny Cade - Work It Out (Original Mix)
Stanny Abram - Genesee
Dajae - Brighter Days (Oliver Knight & Hugo Jones Remix)
Sidney Charles, Hector Moralez - Good Times
Christian Hornbostel Remix
Kydus - The Hustle (Original Mix)
Giuseppe Rizzi - Loco
Jacob Colon - Ready Or Not (Original Mix)
Trust The Drum (That Kid Chris Remix)
Gerry Gonza - Freak The Core (Original Mix)
Renato Cohen - Square Feet (Original Mix)
Diva
The Deepshakerz - Try (Original Mix)
Cobra Khan - Fuck Dat Shit (Original Mix)
Santiago & Bushido - Head Trick (Juan De La Madre Remix)
Seeward - Ararojia (Extended Mix)
Iva Dive - Nirvana (Original Mix)
Y.O.M.C. - Fuck Up Your Earz - (Club Mix) - 1997
The Deepshakerz - Acid Train (Coyu Edit)
Dennis Quin - Fuego (Original Mix)
Javi Lopez - Hook Me (Original Mix)
Marc Suun - This Is Back (Original Mix)
Kraak & Smaak - Let's Go Back (feat. Romanthony) (Chocolate Puma Remix)
Monika Ross - Dark Pimp
Guy Mac - Make You Move (Original Mix)
Loui Fernandez - Marfil (Original Mix)
Enzo Siffredi - Are You Insane
Pole Folder - Everyday (Mashtronic Remix)
Serge Devant - White Groove (Original Mix)
I'm Just Tryna Dance
Brown Vox - Bring It (Original Mix)
Cristian Viviano - Worldless (Original Mix)
Cristhian Balcazar - Feel It (The Deepshakerz Remix)
Miguel Bastida - Emphasis (Original Mix)
Mike Kiraly - Si Mani Revisited (Martin Landsky Remix)
Soul Speech - Soul Speech (Mele Remix)
Sebee - We Spoke (Claytec Remix)
Pirate Copy - Tribal on the Terrace
Ocean Roulette & VNSSA - Magic (Steve Darko Remix)
Andrea Casula - Jumbo Loko (Original Mix)
Rogerio Eduardo - Get Up (Original Mix)
Kevin Over - Sat Rush
N-Telekia - Don't Judge (Original Mix)
Ronnie Spiteri - Rumours (Original Mix)
Wheats, Gene Farris - Freak (Extended Mix)
Q-Co - Quelwasser (Original Mix)
Max Chapman - Feels So Good
Qubiko - The Qube (Original MIx)
George Smeddles - Start The Party (Original Mix)
Last Train (Gianluca Nasci Remix)
Lewis Boardman - Work on Me (Luke Solomon's Body Edit)
Killed Kassette - Box Beat (Extended Mix)
Danny Serrano - Karamba
Peter Pizzutelli - Letters (Club Mix)
DJ Tarkan ft. Yalena - Get Better (Gon Haziri Remix)
Mouzakis - That Thing (Will Monotone's Beat Driven Mix)
Marco C. - No Work (Original Mix)
PAX - Preach (Original Mix)
Son Of 8 - Earth & Moon (Original Mix)
Patrick M - La Havana (Original)
Boys Don't Disco - Keep It Moving (Greco NYC Remix)
Albert Aponte - Powerade (Original Mix)
Oscar Cano - Swimming Thru A Shark Attack (Original Mix)
Mhek - 330 ML (Original Mix)
Babylon
Wayne Dewhurst - Control Alt Delete (Original)
Romano Alfieri - Between Us
Supernova - Maranà (Sllash & Doppe Remix)
Roberto Palmero - Rasta Flag Night (Original Mix)
Lefty D - Coltrane (Original Mix)
SOE119 Seedorf - Charles Truth (Original Mix)
Crowdkillers - What I Do
Emanuele Vernarelli - Open Mind (Original Mix)
Red Weeller - Get Busy
ITLR023 Santero - Bad Boy(Original Mix)
IDQ - Lovin You (Rober Gaez Remix)
Ruben Mandolini - My Fuse (Original Mix)
Ruben Mandolini - No One Else (Original Mix)
Ruben Zurita - Im Back (Original Mix)
Worthy - Moody (Original Mix)
Lok N Key - That Laugh (Original Mix)
DJ Lora - Better Believe (Original Mix)
Umberto Pagliaroli - I Never Miss
Silverfox - Getting Kinda Heavy (Original Mix)
Chusap - Nutter (Original Mix)
Claude VonStroke & Eddy M - Getting Hot [OFFICIAL VIDEO]
Stanny Abram - Jam Hot (Extended Mix)
DJ Hiway - Papi (Original Mix)
Vitamindevo - Kiss The Sky (Original Mix)
Jojo Angel - Alright (Original Mix)
Klangkuenstler - Gonna Leave (Original Mix)
Dale Howard - Satisfaction (Original Mix) [Superfett Records]
Yeah Yeah Yeahs - Heads Will Roll (Jaydon Lewis Remix)
Armand Van Helden - Give Me Your Loving ft. Lorne (Martin Ikin Remix)
Eddy Malano - Never Go Down
Paul Sirrell - Now Hear Dis (Original Mix)
I Wanna Show You (Original Mix)
Doctor Boom - Seven Year Itch (Extended Original Mix)
Hermanez - Go Down (Original Mix)
Juarez - Rio (Original Mix)
DJ Simi - Party Jumpin' (Original Mix)
Cour T. - Black Magic (Original Mix)
Max Chapman, Will Taylor(UK) - HEY! (Original Mix)
Matthias Hoffmann - Get Off (Original Mix)
Mòo & Jo - Lora feat. Lass (Original Mix)
Gabriel & Castellon - Es Vedra (Original Mix)
Joy Marquez - Rolling It (Original Mix)
Kanetaker - Jackin Beats (Original Mix)
Harvey Mckay - B Class (Jon Virtue Remix)
JTRP - Los Santos
Ninetoes - Same Same
Ollie Viero - G.P. House (Original Mix)
Burnski - Another Source (Mandar Remix)
Tim Andresen - Almost Done (Original Mix)
Beatsonik - Maybe (Original Mix)
Undercolors - Roma (Original Mix)
Tim Le Funk - Waiting For The Weekend (Stanny Abram Remix)
Peter Gelderblom, Robbie Taylor - In Your Face (Original Mix)
Sasa Di Toma - Dooh! (Original Mix)
Pete Zorba - She Got Back (Original Mix)
Paolo Solo - Deeplocodocus (Original Mix)
Nasser Baker - Tribes of the Metronome (Original Mix)
Francis Kasibante - Shake It (Original Mix)
Cari Lekebusch, Zoe Xenia - Fly (Ramon Tapia Dubba Dubb Remix)
Louie Vega, The Martinez Brothers, Marc E. Bassy - Let It Go (Dom Dolla Extended Remix)
Kolombo - Remember (Sillaz Remix)
All That She Wants (Original Mix)
The Ger-Man - Agassi (Original Mix)
GIORG, Santez - Paradise (Extended Mix)
Yuri Eleven - Peaktime
Mirco Caruso - Moover (Original Mix)
Anthony Megaro - La Pocion Magica (Original Mix)
Georgio & Martin - That Bling Bling Track
SecondCity, A Double - Let The Music (Extended Mix)
Karl Frampton - DAT Baby (Original Mix)
Reelow - Motherfocker (Original Mix)
Pedro Costa - Mankind (Original Mix)
Max Chapman & Late Replies - Fantasy
Mar-t - You See Me (Original Mix)
Mantu - Artbridge
Oscar L - Konfusion
The Deepshakerz - Moving (Tribe Mix)
Sunset79 - Strong Soul
Ivan Kook - Disco (Original Mix)
Aren Suarez - Decibelio (Original Mix)
Andrea Oliva - Freaks (Solardo Acid Remix)
Steve Kid, John De Mark & Dany Cohiba - Mundo Bueno (Calavera & Manya 'Viva Cuba' Remix)
Minijack Tulip - Future
Daniel Orpi, Juanito - Can't Handle It (Original Mix)
John Rivas - Love Me (Kent FM)
Andy Peimbert - Be House (Original Mix)
Technasia, Green Velvet, Siege - Suga (Siege Extended Mix)
David Kochen - No Way Back (Original Mix)
Montel - Hear Me (Original Mix) [Montel Records]
Semedo - Gonna Leave You (Whitesquare Remix)
Mladen Tomic - Waga (Jon Rundell Remix)
T7A - Nice One! (Original)
Sidney Charles, Lady Vale - Make Me Moove
Guille Placencia & George Privatti - The Sonic Busters (Original Mix)
Snilloc - Najah
Tech Revolution (Original Mix)
Ektor Eros - Space (Original)
Johan S - The Phonk (Original Mix)
Blu Leopard - Everything You Need (Original Mix)
Gianni Cuomo - Words
Arba Han - Fable (Original Mix)
Paolo Solo - Hole (Original Mix)
Danny Serrano - Farina  (Extended Mix)
Jamie Jones & David Berrie - Doctor Zouk
Ernesto Barrese - Not The Same (Original Mix)
Dateless - The O.R
Leo Aguiar, Mattei & Omich - Drop Like That
Luigii Nieto - Day Off (Ruben Naess Remix)
Magic
Rolling Stab (Original Mix)
Drug Bust (Original Mix)
Joaqui Lopez - Trumpet (Original Mix)
Mind Body & Soul (Original Mix)
Kaz James - Life in Purple (Original Mix)
Stefano Crabuzza - Ehoo (Original Mix)
Danny Tenaglia - Dibiza (Ki Creighton Remix)
Piero Scratch - Rampage
Skinnybit - Still Hot (Original Mix)
Ilya Verano - Keep Moving
Oskar Jay - I Want It (Original Mix)
Bassel Darwish - Mezcla
Paolo Solo - Shock Stickers
Seb Zito - Take No One (Original Mix)
Moodymanc - War and Peace (Luke Solomon's Love and Death Remake)
Blaise - Our Love (Original Mix)
Sandy Rivera, Haze - Freak (Amine Edge & DANCE Extended Remix)
Stefan Valletti - Noche Surco (Original Mix)
Karsten Sollors - Six Cents
Quell - Forgive Me (Club Mix)
Oscar Cano - Sehieki
Dom Dolla - Pump The Brakes (Extended Mix) [SWEAT IT OUT]
Fergus Keogh - Sex Drugs Ibiza (Mitch Major Remix)
Calypse - My Money (Original Mix)
Salsa All bout it @Anytime in Belgium
Richey Profond - Hard Times (Original Mix)
Level Groove - Warton (Original Mix)
Eyes Everywhere - What's Your Name (Extended Mix)
Davide Mazzilli - JUST - (Original Mix)
Danny Serrano - Dance With You (Original Mix)
Razzle (Original Mix)
Jakkin Rabbit - The Climax (Original Mix)
Ace of Base - The Sign (Official Music Video)
Eddie Richards - Yeyo (Dachshund Remix)
Cristoph - Smudge
Stefano Ranieri - Break The Beat (Original Mix)
Zoka, Denis Dzeko - Back (Thomas Stieler's Lost Piano Remix)
Wally Lopez, Alvaro Smart - Ipanema (Original Mix)
reDJesh - Free Your Mind (Original Mix)
ZYNK - Pushing (Original Mix)
Davina Moss - Jungle Chic (Original Mix)
African Field (Original Mix)
Tosca - Export Import (Pacifica Remix)
Vidaloca, Piem - Changes (Original Mix)
Rich Wakley - Mic Drop (Original Mix)
Reelow - Amatour Provocateur (Original Mix)
Riddimjunkies - Nothing Wrong
Sydney Blu - You Don't Understand (Original Mix)
Skedar - Freak
Sascha Sonido - Nazca (Original Mix)
Gina Breeze - Heat (Original Mix)
Umek - Everybody Get Up (Original Mix)
J. Worra - some ppl fall
Ruben Amaya - Indioman (Original Mix)
Parris Mitchell, Nina Kraviz - Feel My Butterfly (Jamie Jones Tribute To Aaron Carl Remix)
Ninetoes - Come Back
Mijail - Kicking Loud (Original Mix)
Silverfox - Who Badman Now (Original Mix)
Different Paths (Original Mix)
Fernando Mesa - Infinity (Original Mix)
Landmark - More (The Deepshakerz Remix)
Kristen Knight - URBYF (Original Mix)
Alex Raider - Cyborg Setup (Stanny Abram Abracadabra Remix)
Stanny Abram - Shine On (Miki Mad Remix)
Shaun Thomas - New (Original Mix)
Daniel Sanchez - Itself For Everything EP (Original Mix)
Armitage - Squelch (Sonny Wharton's Doing Dubs Mix)
Andy Moore - Spirit Mush
Gerd - Work Da Tool
Flashmob - City Of Detroit
Dmajer - The Way To Bahamas (Original Mix)
Nicolo Simonelli, OniWax - Broken In The Middle (Original Mix)
Pandeo - Gotta Bass (Original Mix)
Junolarc, Erick Morillo, Redward Martin - Flashlight (Alternative Mix)
Ricochet - Satellites (Original Mix)
JR from Dallas - Smokin Acid
Ray Okpara - Gipsy
Manu Fuentes - Get You (Original Mix)
Andres Campo, Ramiro Lopez - Farly (Original Mix)
Prince.L - Go To Work (Original Mix)
Kim Ann Foxman - It's You That Drives Me Wild (Original Mix)
Mark Blair - Black Cat
Danniel Selfmade & Charlie Demir - United (Original Mix)
Khalifa Cyrus - F.U.N.K (Original Mix)
Roland'Sousa - Drop the Beat
Paolo Solo - Oder (Original Mix)
My Cat Snoop - NARC (Original Mix)
Stanny Abram - Voodoo Master (Original Mix)
Sam Jurgens - We Love (Original Mix)
Chicken Lips 'He Not In'
Juany Bravo - Don't Fuel The Machine (Original Mix)
Carmen - Time To Move (White Groove 88 Edit)
Angel Heredia - La Malagueta (Original Mix)
Junior Sanchez - Believe
Stanny Abram - Shake Yourself (Vocal Mix)
Matas Balta - Rhythm
Bimas - No Rulez At Home (Dub Mix)
Federico Ambrosi - Groovy Monday (Original Mix)
Johan S - Drop The Beat (Extended Mix)
John Barber - Rattlesnake
Elias R - Make Your Rules
Worthy - A Little Weird (Original Mix)
Apollo 84 - Toasted (original mix)
Phonista - Talking (Dan Rubell Rmx)
Raw Mental - Work It (Original Mix)
Hobo - Daydream (Original Mix)
DJ HOWARDKUO - Way Home (Original Mix)
Lars Van Dalen - Katthult [Avenue Recordings]
NightFunk - Pick Up The Phone (Original Mix)
Angelo Ferreri - Drunk To Get Funk (Original Mix)
Jickels - Jackmere (Original Mix)
Taty Munoz - Love and trust (Shawnecy remix)
Dj Hannah - You Wanna Feel (Original Mix)
Piero Pirupa - Bananas
Agei - Radio Cluj (Original Mix)
Koen Groeneveld & Capo Copa - Bum Bom (Koen Groeneveld Re-Edit)
Solardo, CamelPhat -  Accelerator
Eddy M - Dropping (Original Mix)
Mylan - Question
CASSIMM, Marck Jamz - Samba (Original Mix)
Smells Like Rhythm
Jay Lumen - The Journey Pt. 1 (Original Mix) [Great Stuff]
Agar - Time To Relax (Original Mix)
The Martinez Brothers, Miss Kittin - Stuff In The Trunk (AJ Christou Dub)
Kevin Knapp - Soul Shopping
Tacoman, Raized - 90's MTV
Joeski - In Time (Original Mix)
Rendher, Richard Ulh - Dancing Like Madonna
Kojaki - Sesimb (Original Mix)
Max Kernmayer - Body Controller (Original Mix)
Nico Balducci - Backstage (Original Mix)
Majemba
Ben Sterling - Wonky (Original Mix)
Venditti Bros - Bad Moves (Extended Mix)
I Want You Back (Branzei Remix)
Alex Raider - Hermes (Original Mix)
Jack Cousteau - Ghetto Code (Original Mix)
Alvaro Smart - Just like that (Original Mix)
Moshem - Big Boy (Extended Mix)
Reach Out And Touch Faith (Mike Ivy Remix Radio Edit)
Sacha Robotti - Low Key Goddess (Original Mix)
Enzo Siragusa, Rossko - Dreamers
Carlo Marani - Cheeky (Original Mix)
2 Sides Of Soul - House Lovers (Original Mix)
Frag Maddin - Forward
Fellar - The Jazz Cat Funk (Original Mix)
Danny Howard, GUZ (NL) - All That Dancin' (Danny Howard VIP)
Jamie Jones, Harvy Valencia - Electric Mama (Original Mix)
Boris Roodbwoy - Is It You (No Hopes Remix)
Robert Dietz - Pherrox
Stanny Abram - How You Doin (Original Mix)
Max Chapman - You Just Won't (Original Mix)
Emeskay - Mahila (Original Mix)
PEZNT - Anytime (Original Mix)
Reelow - High You Feel (Original Mix)
Dale Howard - Headcase
Oliver Klein - What U Got (short version)
ATFC - Feel It (Original Mix)
Lex & Wood - Get Up (Lee Walker's Straight Up Extended Remix)
Simon Kiisk - Orbit (Extended Mix)
Anthony Attalla - Fever (Pirupa Remix)
Karl Malone - Bitzen (Original Mix)
Latmun - Again
Guezmark & Joe Diem -  Feel so good Original mix
Danny Serrano - I Get Deep (Original Mix)
Dido - Give You Up (Mark Knight Remix)
Freestyle Man - Kaiku (Original Mix)
Eddy M - Dropping
Dennis Ferrer - Destination (Mihalis Safras Remix)
Eats Everything - Chitter Chatter (Dub)
FreedomB - Twister (Extended Mix)
Gabriel Carrillo - Colossus (Original Mix)
Todd Terry - Babalon (InHouse Mix)
Tetchy - You Cant Hold Me Down (Original Mix)
World Vibe Music Project - My Fire (Vocal Extended Mix)
Josh Butler - Wanna say (Original Mix)
Andres Blows - Anxiety (Original Mix)
Lexa Hill - Blast the Funk
Mene - Ego Basics (Original Mix)
LucaJLove - Yeah
Andres Luque - Caelum (Original Mix)
Laera - Cabeza Loca
Sven Tasnadi, David Jach - Nothing
Joe Diem - The Tribe
FOALS - Into The Surf [Hot Since 82 Remix] (Official Audio)
Tom Flynn - Seduction (Original)
Ashibah - I Ain't Promiscuous
Melé - Sleepless (Lord Leopard Remix)
Sundowners, Mystic Bill - Jungle Line (Eats Everything Modernisation)
Eddy M - Feel My Flow (Original Mix)
Peter Pavlov - All About House (Original Mix)
Enzo Siragusa - Paradigm Shift
CASSIMM, Vanilla Ace - Get Loose (Original Mix)
Matthias Tanzmann - Lumas (Original Mix)
Alessio Collesano - Don't Take Your Time (Original Mix)
LATROIT - Everything is Beautiful (Avon Stringer Remix) [FULL SONG]
Raoul French - Bad Girl (Original Mix)
Stan Garac - Now!
Hoshina Anniversary - A Cid [JACKDEPT011]
Aitor Ronda - Wicked Night
Paul Sirrell - Don't Stop (Original Mix)
David Herrero - Funny Band (Original Mix)
Dan Rubell - Oiso
Manu Desrets - Groopo
Fhaken - God Is A DJ (Extended Mix)
Macrolev - Just Dance (Extended Mix)
Heller & Farley Project - Ultra Flava (Darius Syrossian's Full Pressure Extended Remix)
Jose de los Santos - Mariposas (Original Mix)
Scuba - Too Strong (Cuartero Remix)
Angel Heredia - Get Out (Original Mix)
Emeskay - Listen (Martinez & Quadelli Remix) [DRR022]
Funk D'Void - Jack Me Off (Ben Sims Remix)
Ben Remember - Run River (Original Mix)
Casbah (Original Mix)
Luca M, JUST2 - Descent (Original Mix)
Mike Newman - The Whisperer
Refuse (Johannes Brecht Remix)
Sigother - Converting
PEZNT - You Got Me feat. Sheree Hicks
LucaJLove, BRADII - House Music Is (Amorhouse Remix)
Dennis Ramoon - Keep Me Up All Night (Original Mix)
Mario Franca - Europa (Original Mix)
Stefano Noferini - Makaly
Vicca - Exit
Carlo Marani - Don't Touch The Dial (Original Mix)
Majesty - 27 Club
Chris Di Perri, Anker - Te Quiero (Original Mix)
Lewis Boardman - Taste It (Original Mix)
Nikhony - Say It All (Original Mix)
Barry Obzee - I'll Be The Music (Original Mix)
Fabio Neural - Shuzu
Mirco Caruso - Next Guest (Original Mix)
Jibberish (Original Mix)
Luuk van Dijk - Work (Original Mix)
Kreature - Ambition (Original Mix)
The Martinez Brothers - H2DAIZZO (Guti & Enzo Siragusa Remix)
Crazy Fluke - Obey (Extended Mix)
Rich Wakley - Chase The Same High
Latmun - Hard Play
Lissat, Voltaxx - The Sunken Bells Of Ibiza (Original)
PEZNT, Brown Sneakers - You Know What (Extended Mix)
Max Freeze & Papa Marlin - Show Me
Tapesh - Planet X
Sex Sells - Ain't No Wifey (Original Mix)
Steve Darko feat. Nala - Red [DIRTYBIRD]
Ben Jones - Rise (Original Mix)
Freakx Brothers - Burn My Ghettoblaster (Chris Lake Edit) (Chris Lake Miami Edit)
Luna City Express - Work Together (Dario D'Attis Remix)
Mat.Joe - Infective (Original Mix)
George Privatti - Appointed (Original Mix)
Pakhi Dogs - Space Train (Original Mix)
UY066 Marco Resmann - Twelve
Sven Tasnadi - Back Again (Original Mix)
Bassjackers & MAKJ - DERP (Official Video)
Wade - Boyz In Da Hood (Camelphat Remix)
Rick Silva - Colombian Plan (Original Mix)
Piccolezze (Original Mix)
Neu Nox - To Transmit
Avermass - Get Away
Gebreski - The Interview (Original Mix)
Steve Kid - Circles (Original Mix)
Percy X - X Trak 1 (Joris Voorn Remix)
Anton Jay, Discoplace - Dangerous
Jacque Saravanté - Get Those Ideas Out (Original Mix)
Andrew Macari - Body Needs
Sasa Di Toma - The Gem (Original Mix)
Reblok - Your Face (Original Mix)
[WU006] Miguel Moraleda - El Manubrio (Original Mix)
Giancarlo Zara - Why (Original Mix)
The Reaver - Mmmm (Original Mix)
Mizbee - Joy (Mark Jenkyns Remix)
Yoga Queef - Hubba (Jesse Perez Wuz Here Edit)
DJ Dep - Seven Spades (Original Mix)
Oliver Moldan - Turn Off the Lights
The Deepshakerz - Wake Up (original)
Kim Fai - P.S. (Original Mix)
Garry Todd, Jessica Derrick - Wait For Me
Glenn Loopez - Break It Up (Jozik Remix)
Mladen Tomic - Tribe Touring (Original Mix)
Xenso - Depths of Acid (Original Mix)
Whomadewho - Heads Above (Maceo Plex Remix)
Cosimo Mele - Close Your Eyes (Original)
Taster Peter - Romance (Original Mix)
Marco Berto - Sykorski (Original Mix)
Kevin Rodriguez - Remember It (Original Mix)
Meen - This High (Original Mix)
Piero Scratch - Back On Decks (Original Mix)
Haunting (Original Mix)
Chris Brogan - Make It Hot (Original)
Eskuche live from NYC rooftop
Recourse (feat. Cari Golden)
Dirty Dan - Dirty Rhythm
Paperclip People - Parking Garage Politics (Eats Everything Edit)
Dubclap - High
Late Replies - Hold Up (Original Mix)
Mad Morello - Amazonas (Original Mix)
Emanuel Satie - Queens
Cristian Fiume - Tanzania (Manolo Remix)
Franky Rizardo - Give It Up (Original Mix)
Harvy Valencia, Jamie Jones - Electric Mama (Original Mix)
Lee Walker - Introvert (Stanny Abram Remix)
Sharkslayer - Reefer Shark (Dub Mix)
Aj Lora - Chicago Sub (Original Mix)
Fhaken - Dumba (Original Mix)
Ray MD - La Virgen (Original Mix)
Jordano Roosevelt - Enjoy (Original Mix)
Hannes Bruniic - House of God
Luna City Express - The Next Level (Audiojack Remix)
Bailalo (Original Mix)
Jax D - Wee
Tristram Shandy - Don't Want (Original Mix)
Supernova - Satisfied (Original Mix)
Coupe Melba - Libre De Quererte (Extended Mix)
Max Chapman - Danger (Original Mix)
Khalifa Cyrus - G Thing (Original Mix)
Hold It (Extended Mix)
DJ Entwan - You Know What I Need (Danny Serrano Remix)
Francesco Dinoia - Discotheque (Original Mix)
Rhythm Masters, MYNC, Wynter Gordon - I Feel Love (DJ PP Remix)
Benihana - Quiero
Marco Lys - The Story Continues (Extended Mix)
Majesty - Step Up (Original Mix)
Roland Leesker - Music Is Here (DJ Pierre Jack Remix)
Sharam Jey, Jean Bacarreza - Push It! (Original Mix)
Francesco Poggi - La Musica Es
Enrico Caruso - I'd Wait A Lifetime
Riccardo Barbaro - Love For Music (Original Mix)
Dennis Quin - Bizznizz (Original Mix)
CASSIMM - Rock It Now (Original Mix)
Lewis Boardman - Summertime (Original Mix)
Mirko Di Florio - Long Time (Extended Mix)
Dale Howard - Need U (Original Mix)
Phuture Phunk - Under The Ground (Original Mix)
Mirco Caruso - Yango
CASSIMM - All Over Me (Karuva Remix)
Maroy - Gonna Be Me (Original Mix)
Pagano - Peace & Unity (Extended Mix)
Late Replies - Just Like Me (Extended Mix)
Disco (Original Mix)
Caravaca - Compression (Original Mix)
Gene Farris - Higher Ground (Latmun Remix)
Just Came For The Music (Rave Mix)
Eydrian - What Is Your What is Mine (F.Gazza Juan De La Higuera Remix)
Sonny Wharton - Badboy (Original Mix)
Marco Lys, Gene Farris - Turn It Up (Extended Mix)
Di Chiara Brothers - Black Chan EP (Original Mix)
Jack's Brothers - Funky Feel (Original Mix)
Sydney Blu - Understood (Original Mix)
Tiger Stripes - Moan (Original Mix)
Gemini 529 - One Gun (Original Mix)
Dean Mickoski, Simon Field, Baby Sol - Basement (Extended Mix)
Peppe Markese - House Music Everywhere (Original Mix)
Coyu - Vertigo
CamelPhat - It Is What It Is (Kevin McKay Remix)
Gary Caos - Gary In Da Club (Original Mix)
Girl - Original Mix
Jason Munoz - Mr. Charles (Original Mix)
Arno Stolz - Rights (Original Mix)
Claude VonStroke - Barrump
TR-MEET - Dancefloor (Original Mix)
Blakkat - Touch (The Glitz Remix)
Lupe Fuentes - Bassline (Original Mix)
[Tech House] Little Fritter - London Flex (Original Mix)
Daniel Orpi - Amazon (Original Mix)
MCMXC Made - Control Direction (Original Mix)
Aiho - Magura (Original Mix)
Ilary Montanari - Si Tu Vives (David Museen, Erik Christiansen Remix)
Modström - Paradise (Original Mix)
Disco Sugar - Kairos (Juan Diazo Remix)
AKANE. - Acid Rain (Original Mix)
PachangaStorm, Oliver Deuerling - Tranquilo (Enzo Siffredi Remix)
Rejoyce - Holler Girls (Luca Donzelli Danzen remix)
Endor - Pump it Up (Jax Jones Midnight Snack Remix)
Alex Harrington - Feel It (Antdadope Remix)
D'Gian - Boobie To The Boogie (Original Mix)
Mauro Venti - Don't Stop (Original Mix)
Paul Jays - Spiritual Battery (Chus & Ceballos Remix)
Prok & Fitch - One of These Days (Original Mix)
Fisher - You Little Beauty (Original Mix)
Mihai Popoviciu - Tomorrow (Original Mix)
Kevin Knapp - Survivor (Original Mix)
Daniel Jaeger - Creepwalker (DirrtyDishes Remix)
Andrew Macari - Do Ya
Flashmob - Switch (Hobo Remix)
Dj Vivona - You Are (Wade Remix)
Alex Twitchy, Alex Aveiro - Prose (Original Mix)
Alex Raider - Tiwanaku (Original Mix)
Viana - Moonlight (JP Chronic 909 Remix)
Emeskay - Look Back (Original Mix)
Richy Ahmed - Bad Boy (Enzo Siragusa Remix)
Andrew Mina, Paolo Paleologo - I Like It (Kevin McKay Extended Remix)
Abbott (Original Mix)
Andre Rizo - Feel (Extended Mix)
Vanilla Ace - Fire In The Disco (Original Mix)
Cyberx - Take Me Back (Original Mix)
Tim Le Funk - Acid Rocker (Original Mix)
Darksidevinyl - Jago
Karlos Cheadle - Walkin Talkin (Original Mix)
Rick Sanders - That's It (Original Mix) Smiley Fingers
Orlando Voorn, Patrick Steger - Batman 25 (Original Mix)
Franz Costa - Keep On
Angelo Scalici - Gonna Do What! (Original Mix)
Charles Ramirez - House Masters (Original Mix)
Hof 029 Charles Ramirez, J.NANDEZ -  La bicicleta (original Mix)
TNT - Beat Track 2 (DJ Oyster Edit)
Matteo Floris - Rizla (Original Mix)
Flytrap - Incredible (Original Mix)
Pelvis Moves - London Compton (Extended Mix)
Bollen & Fichtner - Mad Man
Underground Mafia - The Godfather (Jesse Perez Retouch)
Nina Schatz - Turquoise (Original Mix)
Clyde P - The Crypt (Original Mix)
HowTru - How I House (Extended Mix)
Nico Cabeza - Odin (Original Mix)
Control (Original Mix)
Italoboyz - Gin & Acid (Original Mix)
Brown Vox - Focal Vocal (Original Mix)
Christian Arno - Needle To Da Record (Original Mix)
Di Chiara Brothers - Our Place (Original Mix)
Dennis Cruz - Fuck (Original Mix)
Branco Simonetti - Make The Building Shake (Original Mix)
Anatta - Kickback Afterhours (Original Mix)
Ray MD - La Ciguapa (Original Mix)
Rework - Rise and Fall (Original Mix)
Dany Cohiba - Take My Breath (Original Mix)
Kataa - Going Deeper (Qubiko Extended Dub)
Sven Tasnadi - Animal
2 Sides Of Soul - Dust (Original Mix)
Camel Phat, Riva Star - Electricity (Original Mix)
Stanny Abram - Sweet Lorraine's
Magnus Wedberg - Swedish Beatballs (Anthony DeVito Remix)
Alex Marttin - Body Like (Original Mix)
Mihai Popoviciu - Fiction (Original Mix)
Sonickraft, Blvckr - Rebel (Original Mix)
Ciszak - La Bomba (Original Mix)
Call Me (Original Mix)
Plus Beat'Z, Joseph Vier, HAGUILAR - Lick It (Original Mix)
Sakke - Came Too Deep (Original)
Simone Liberali - Huracán
Avante (UK) - Secrets (Extended Mix)
Hot Since 82 - Bloodlines
Gogan - Clap Your Headz (Original Mix)
NivesKa - Nyumbani (Original Mix)
Sammy W & Alex E - Cragged
Giulio Cadri - Like That (Original Mix)
Pirupa, Malandra Jr. - My Weapon (Original Mix)
Miane - W You
The Way You Make Me Feel (Original Mix)
Superlover - The Talking Machine
Lenny Kiser - TAT (Original Mix)
Tigerskin, Jack Jenson - Ladies Nite
Philip Bader - Common (Raffa FL remix)
Jowe X - Excited (Original Mix)
Dj Lugo - Astral
Rekord 61 - Nedra (Glimpse Remix)
Apollo 84 - Groove Shaker (Ciszak Remix)
Lexa Hill - The Checkup (Original Mix)
Audiofly, Fiora - 6 Degrees (Booka Shade Remix)
Jay Lumen, Harvey Mckay - Two
Eva Be - Delight
Ron Costa - Pisah (Original Mix)
Enzo Siffredi - People
Thomas Hensbroek - Amarula
Technotronic - Pump up the Jam (Nightfunk Remix)
ALISHA - Pre Play
Gorge, Ira Ange - Deep Clouds Feat. Ira Ange (Danny Serrano Remix)
Sante Sansone - Raw Monsters
Poor Pay Rich - Tessellation (Original Mix)
Johan S & Reza - Never Let It Go (Extended Mix)
Nils Ohrmann, Sqim - Real Deal
D-Unity - Prophet (Original Mix)
Pascal Moreno, Tyron Kemble - Maranello (Original Mix)
Onno - Hablando Loco (Original Mix)
The Golden Boy - Egyptian Lover (Latmun Remix)
Joba - The Rave (Original Mix)
Robosonic - Busted
Joeski - Montes
Flashmob - The Lone Brazilian (Original Mix)
Danny Rhys - In Motion (Extended Mix)
Cele - True Game (Original Mix)
Myles - Acid (Original Mix)
Richard Dinsdale - What I Do (Original Club Mix)
Espinal & Nova - Look At Me (Original Mix)
Ricardo Espino - Iceberg
Active Line Six - Roller Coaster
Marco Lys - You'll Be Mine (Extended Mix)
Route 94 - House & Pressure
B-liv - Se Aproxima el Aguacero
Ricardo Motta - Ladies Night
Jay de Lys - Youngster (Original Mix)
Moreno Pezzolato - Need U
Kaily x Blandy - Up In Smoke (A Lister Remix)
Shapeless, Loudtech, Dunno - Kaleo (Original Mix)
Kasbah Zoo - Freak Construction (Original Mix)
Darius Syrossian - Soul Fire (Original Mix)
Metodi Hristov - Wrong Orbit (Original Mix) [SET ABOUT]
Javi Lopez - Extreme (Aj Lora Remix)
Dreams of Morjim
A.Side - Countdown
Dany Cohiba - Luz Da Lua (Original Mix)
Ruben Mandolini - FKNGT
George Smeddles - How I Feel (Original Mix)
Marcos Arreza - Darkness
Itamar Sagi - Dreams Theater (Original Mix)
2 Good Souls - Juicy (Original Mix)
Ego Valente - La flauta (Mitch Major Remix)
Pump (Original Mix)
Under_Score - Come With Me (Original Mix)
Daniele Allegrezza - Great Boy
Damon Hess - Dance All Night (Original Mix)
Melting Plastic - Refueled
Hauswerks - After Dark
Michael Vinciguerra - MV's Groove (Original Mix)
Tony Metric - Moves (Denis Ago Remix)
Next Time (Original Mix)
Kevin Over - Basement
Varen - Blush (Carlo Marani Remix)
Max Chapman, Late Replies - Wassoulou
Stanny Abram - Believe (Original mix)
DeWalta - Double Helix (Original)
MSCLS - Critical Error (feat. DMG$) (Original Mix)
Mascu & Ovidi Adlert - Nairobi Tribe (Original Mix)
Johan S - Put It Through (Original Mix)
Styline & Phunk Investigation - Protest
Curtis Jay - Dangerous Love
Xuko - Shoot Em Down (Original Mix)
Bontan - Sweat
The Deepshakerz - Baby Doll (Original Mix)
Rey Aguilar - Oye Mami (Oscar G Remix)
Steven V - Jack Way Down
Agoria - Up All Night (Eagles & Butterflies Remix)
Noone Costelo - Drink Responsibly (Original Mix) [Abracadabra Recordings]
Martin Dawson - Double Six (Ramon Tapia Remix)
Amorhouse - I Wanna Touch You
MS Pika - Move Yoou Body (Original Mix)
Tripmastaz - Blossomz
Seb Zito - You Don't See Me
Roberto Surace - Joys (Paco Osuna Extended Remix)
Mat.Theo - Signals - Volume 2 (Original Mix)
Harry Romero - Aquarium
Jon Costas - Keep It Pumping (Original Mix)
Stefan K - All Night (Original Mix)
Dj Csemak - Hands Up (Original Mix)
SOAME - Stamp (Original)
First Time (Original Mix)
Sam Holland - Desires
Bardia F - White Girls (Original)
DeeAfro - Don't Go Away (Original Mix)
LucaJLove - Wasted (Original Mix)
Francesco Dinoia - Bassline Mind (Extended Mix)
Fabian Haneke, Sarah Fall & Divine - Easy
David Aurel - Hera
Chocolate Puma, Mike Cervello, Dennis Quin - You Are My Life (Dennis Quin Extended Remix)
Facundo Altuna - Coraje (Original Mix)
Rhoowax, Iglesias - Keep On Dancin' (Original Mix) [Noexcuse Records]
Nico Mendez & JAXX - Crooked Sh.T (Original Mix)
Miroslav Krstic - Golde Age (Original Mix)
Martin Phill - Summer Night (Original Mix)
Sasa Di Toma - Baby Knife (Original Mix)
Mike Catherall - The Organ Project (Original Mix)
Soulrack - Feel The Fire (Original Mix)
David Keno - Represent (Original Mix)
Imanol Molina - Synthcopter
Maluma, Jennifer Lopez - Lonely (Official Video)
Armandd G, Tektonauts - Wawawa (Original Mix)
Stanny Abram - Gotta Let You Move
Amarone (Original Mix)
Eskuche - Dance
Ronnie Spiteri - Musical Minds (Original Mix)
Riven - Big Moaner (Original Mix)
Igor Vicente - The Knight (Original Mix)
Stephan Duy - Soundsystem (Extended Mix)
Guti - So Dope (Original Mix)
Coyu - Just Nin (Andre Lodemann Remix)
Isaac Highway - Push Me
Fideles - What I Show to You
Dennis Ramoon, Alex Sandrino - Rude Boys (Original Mix)
maroglio.jay - Murk (Original Mix)
Josh Hunter & Mila Falls - Moving On Up
DJ Rooster - Drum Machine (Original Mix)
Florian Meindl - Warehouse Dub (Original Mix)
Alexic Rod - We Back (Original Mix)
Amorhouse - Party People
Soul Speech - Morning Light (Original Mix)
Enzino - Mood
TAVA, Gosts, Stefano Pain - Discoteca
Dj Infinet - Bender (Original Mix)
Roter & Lewis - Rare Funk (Original Mix)
MS Pika - Discotech (Original Mix)
Kuestenklatsch - Ever Know (Original Mix)
Joshwa (UK) - Praise You (Club Mix)
Beatmode - Phatt Rat (Johnny Krazy The Cat Bounce Remix)
Aaran D - Give You Up (Original Mix)
Marco C. - Get Down (Original Mix)
Lex & Wood, Dead Space, Pony - Hussy (Original Mix)
Rework - Missed You at L
Legendary Boy - Groove On (Original Mix)
Mak Negron - Maniac (Original Mix)
Dale Howard - Trouble (Original Mix)
Francis Kasibante - Disbelief (Original Mix)
FreedomB - Juicy Groove
Respect Througts (Paul Hamilton Remix)
Worthy - Activate The Booty (Original Mix)
Hyperloop - Resilience
Desena - Sax to Me (Original Mix)
Benny Royal - The Hustle (Original Mix)
Le Vinyl - Impulso
Ratahi - Swasi
Alex Par - In Between
B-liv - IL 60661 (B-Liv Full Down 124)
909 Til Infinity - Drop The Mic
Solardo & Wade - Everybody
Dirtyplan - Kilonova (Javi Lopez Remix)
Bastien, Crespo - Balance (Original Mix)
Sante - Ghostwriter (Original Mix)
Love Regenerator, Steve Lacy - Live Without Your Love (MK Remix)
Marshall Applewhite - Cheddar Bae
Hey Baby (Original Mix)
Joeski - Like This (Original)
Lewis Boardman - Summertime
M.in - Underrated Priviledge (Will Monotone's Beat Driven Mix)
Paco Maroto - La Banda (Original Mix)
Paolo Rocco - Move Body, Move Forward (Nathan Barato Remix)
Kokks & Lein - Shouts
Horatio - Everybody Loves (Original Mix)
Yves Eaux & Ruslan Cross - Wearing My Rolex (Kike De Anda Remix) [Tech-House]
Steal Tapes - Keep On Frequency (Original Mix)
Stanny Abram - Magista (Original Mix)
La Guaira (Philipp Lammers Remix)
Dirty Vegas, Sammy Porter - Days Go By (Sammy Porter Remix)
Bill Fragos - 23rd Street (Stanny Abram Abracadabra Remix)
Jerome Baker - Let's Go
Roderick Fox - Instinct (Original Mix)
Kenny Brian - Banjo (Original Mix)
It Takes Me (Original Mix)
Tom Flynn - White Drum (Original Mix)
Tucci - Hit 'em Up (Original Mix)
Piem - Freakin (Thabo Getsome & Distale Remix)
Freakin' (Original Mix)
Tenacious - Rabbit Hole (Original Mix)
Mat.Joe - When You Hear That Sound (Original Mix)
Matrix III - Sequences
Jack n Danny - Rock A Bar Baby (Original Mix)
Lorenzo De Blanck - I Want Stand (Original Mix)
Hakan Akkus - I Can't Be (Drop G & Regard Remix)
Monki - The Shed (Original Mix)
Chris Hartwig - Take It Easy (Original Mix)
Savve - This Funk
Supernova - The Noise (Harry Romero Remix)
Billy Sizemore - Take Me (Stanny Abram Remix)
Toby Dreher - Girl In A Hurry
Rhythm Masters - Yo (Original Mix)
Dantiez, Per QX - The Collaboration Track (Tech Mix)
Proudly People - Enemy N1 (Original Mix)
th;en, Starkato - Echo People (Original Mix)
Luca Beni - Dark Tribe (Original Mix)
Huseq - Starry Palms (Robiin Remix)
Alex Harrington - Mello Yello (Original Mix)
LAB040 Ange Siddhar - One EP MEDLEY incl. Cesko & Illan Nicciani [VINYL ONLY]
Siempre
Arado - Positive Minds
Tyler Coey - Weiki (Extended Mix)
The Ger-Man - Feel My Heart (Original Mix)
Lenny Hoffman - Get It On (Stanny Abram Remix)
Patrick Topping - Rocket Fuel
Chris Main - Bite
Benedetto & Farina - Time to Party
DJ PP, Jack Mood - Ghosts
Huxley, Skapes - Shut Down (Original Mix) [Relief]
Dennis Ramoon - Get The Bassline (Original Mix)
Truce - Code (Original Mix)
Detroit Project - Dangerous (Original Mix)
Daniel Stefanik - Deep Inside
De La Swing - Face To Face (Enter The Rave Rework)
Luca Donzelli, Mar-t - Devo To Acid
Circle - Opening Windows (Funtom Detorit Mix)
Hermann Bravo - Get Into It (Original Mix)
Hannah Wants - I Want U (Original Mix)
RFTT - Hidden Subtleties
Affani - Jammin (Original Mix)
Marco Anzalone - Arena (Original Mix)
Jason Young - Electric Bass (Matthew Codek Remix)
Ian Jay, Matt Williams - Last Night (Mhod Remix)
Reblok, ATMA (AU) - Peanut Butter Maniac
Talkin About
Javi Lopez - Fundamentals (Original Mix)
Luca D'Arle - No Way (Dyna)
Daniele Andriani - Buzzin
Ekoboy - Party Time (Original Mix)
Luca Bisori - I Want (Original Mix)
Dubtechie - Undbeer (Original Mix)
Ben Rau, Jansons - The Player
Fond8 - Digital Rhythms
Mirco Caruso - Higher (Original Mix)
Harry Ley - The Doctor (Original Mix)
RanchaTek - Get The Funk Back (Original Mix)
Ray Okpara - Palmascal (Original Mix)
KI Creighton - Jessie's Jam (Original Mix)
Cuartero - Moon Crash (Original Mix)
Nastee Nev feat. Donald Sheffey - I'm So Hung Up On You (Infinite Boys Mix)
Taron-Trekka - Yellow Magic
Carlo Marani - Don't Stop (Original Mix)
Peter Brown - Don't Stop (Glovibes vs. Handzoff Remix)
Victor Vera - Generation (Original MIx)
Alex Harrington - Feel It (Original Mix)
Mihalis Safras, Raffa FL - Freedom (Mat.Joe Remix)
Calle Lebraun - Because of Me
#48 Deep and Progressive House mix 2016
Boris Ross, Chicago Hustle - Fake (Original Mix)
Zivo - Papercut (Original Mix)
Qubachki - Triangle (Original Mix)
James Burton - Sounds Of A Different Colour (Ki Creighton Remix)
Dateless - Lady Make Me See
Branzei - Watershead (Original Mix)
Basement UK - Hitman (Original Mix)
Waitz - THPS
Jop & Jordi - Ich Hab Noch Einen Koffer In Berlin (Youri Donatz & Bjorn Wolf Remix)
Flash Mob - The Lone Brazilian (Original Mix)
Vibe Killers - Where Are You Taking Me (Original Mix)
Dale Howard - Let Me Be (Original Mix)
HOW MANY - Dani Barrera (Original Mix)
ASAL - Aspirin (Original Mix)
Stacy Burket - Cuban Cookies (Torticas De Moron) (Main Mix)
Chus & Ceballos, DJ Chus, Pablo Ceballos - Been a Long Time (Feat. The Fog) (Album Version)
Lee Foss & Martin Ikin- Gravity  Feat. Hayley May (Main Mix)
David Keno - Resonate (Original Mix)
Markus Homm - 2soul (Martin Landsky Remix)
Neverdogs - Reality (Original Mix)
Mendo melody russ yallop Remix
Baum, Caal - Vermouth (Original Mix)
Saeed Younan - Drop It (Original Mix)
Antranig - JACKIN' (Erick Morillo Extended Remix)
Joeski - Mud Funk (Original)
Qubiko - Bidibody
Kim Kaey - Loving U (Official Lyric Video)
Felix Da Housecat, Kristin Velvet - Marshall & Pierre
Stewart Wilson - Insect
Waze & Odyssey - Down With Tha
Dardo Roth - Mathafacka (Original Mix)
Huxley - Freekon
GODDARD - Acid Or Techno (Original Mix)
Black V Neck - Sex, Drugs, Alcohol
Stanny Abram - In My Arms (Extended Mix)
Rich Wakley - Gin & Chronic (Original Mix)
Friend Within - Matchbox
Jake Ness - Rhatta (Original Mix)
Rob Nutek - War Boy (Original Mix)
Ejeca - Ekstac (Maya Jane Coles Remix)
Harry Romero - The Culture (Extended Mix)
Junior Jack, Pat BDS - Klimax (Darius Syrossian Remix)
Chambray - Pim Dive (Original Mix)
Jojo Angel - Tha Bit (CDC UK Remix)
Mandingo - Another Dub On Earth (Original Mix)
HumanTraffik - Never Sound Mono
Being Me (Dub Remix)
Moonlight (Original Mix)
Leon Blaq, Nino Bellemo, Astada - Up & Down (Original Mix)
Fabbie - Groove On The Street (Original Mix)
Craig & Grant Gordon - Hold Me (Original Mix)
Rainer Weichhold - Reis (Jay Lumen Remix)
Eduardo Drumn - Hallucinate Their Minds
Matt Caseli & David Jimenez feat. Austin King, Matt Caseli, David Jimenez, Austin King - Good Old Days (Original Percussive Mix)
Alex Rai - Other Games (Original Mix)
Coda - Break of Dawn (Original Mix)
Nik Feral - Illuminatum (Album Mix)
Max Chapman - La Fiesta (Original Mix)
Super Flu - Monaberry (Matthias Tanzmann Remix)
Robiin - Take Over Control (Original Mix)
2020Soundsystem - Psycho (Subb-an Remix)
Ozzie Guven - Vision (Original Mix)
Spacefunk Dub - London Thing (Original Mix)
Medeew, Chicks Luv Us, Sergio Diaz - Mind Control
Nino Bua - Take Me For A Ride (Original Mix)
Saeed Younan - All The Haters Stay Clear
Carlos Torre, DJ Tooper - Let Me Tell You (Original Mix)
Sonny Wharton - Vice
Lupe Fuentes - 1000 Watts (Kerri Kaoz Chandler Vocal Dub)
Paolo Solo - Body Language (Original Mix)
Rsquared - Stella
Joseph K - Open Space (Original Mix)
Lars Horton - Yes, I Did It (Christian Hornbostel Rmx)
AmyElle - Feel The Heat (Extended Mix)
R.AM - Ad Finem
Soul Mob - Bunk (Vocal Mix)
Miane, Medusa - Say It (Original Mix)
Kokks & Lein - Tribe Speech
Paul Sirrell - Dub Number Five (Original Mix)
Stefan K - Sweat (Extended Mix)
Constipated Monkeys - Music Takes Control (Marco Lys Extended Remix)
Beat Diddy - 1252 (Original Mix)
Michael James - The Story Unfolds (Original Mix)
Sinner & James - Do Ya Thang
Pushin Beats
Uch - Genius Of House (Eskuche Remix)
Daniel Orpi - Getcha (Original Mix)
Dave Storm - Don't Stop (Carl Phaffa & Mike Moorish Remix) [Phoenix Music]
Danny Serrano, Mendo - Grush (Original Mix)
Majesty - Spot On
Nick Olivetti - Bee Beat
Waifs & Strays - Fire In Me
Martin Landsky - Echo In My Head
Chris York - Do You Ever Feel (Original)
Enzo Tucci - Devotion
ABASAF - LP Free (Original Mix)
Vanished (original)
Waze & Odyssey - Down With Tha (Original Mix)
A Bit Sketchy (Original Mix)
Chriss Matto - Rave (Original Mix)
PAAX - Sera El Sol (Harry Romero Extended Remix)
Kevin McKay - Fever Called Love (Extended Mix)
Rhythm Masters ft. Kenny Dope - 20 Year Cycle (sixshadows edit)
PEZNT - Robi Ivek (Original Mix)
Speed (Miguel Bastida Remix)
DJ Entwan - To The Beat (Original Mix)
Will Monotone - Rulers Of The World (Original Mix)
Blvckr, Morsy - Still Loco
Jojo Angel - Sh!t Mate (Original Mix)
Lars Wickinger - Fake You (Original Mix)
Jowe X - Overdub
Alex M (Italy) - Show U Love
Ginga Kikoutai Majestic Prince Episode 1 English Dub
Martin Lacroix - Rever-C (Stephen Macias Remix)
Menesix - House Tripper (Original Mix)
Axwell - Nobody Else (A-Trak Extended Remix)
Understate - Shine (Exteded Mix)
Barry Obzee - Connection (Original Mix)
AYAREZ - Got Your Back (Original Mix)
Paolo Martini - I Won't Stop (Dee No Remix)
Frankie's Story (Extended Mix)
Miguel Bastida - Dona
CASSIMM - Caravan (Extended Mix)
Simon Ray - Burnin' Up Inside (Extended Mix)
Justin Jay - Don't Trip (Original Mix)
James Meid - This Check Out (Original Mix)
Indian Rave Hand
DoomWork - Down Town (Will Monotone Remix)
Drop 2 Jump - Everybody Back
Das Orlando - El Gaitero (Luis Pitti Remix)
Sting - Englishman In New York
Abbo - Drug Free (Max Chapman Remix)
Sonickraft - Nightcrawlers (Original Mix)
Craig Robinson - Grey Emotions (Original)
Eyes Everywhere - Kmart Krump
Joeski - Inside My Mind (Andre Butano & Phillip Liard Rmx)
Wolf Story - Music Please (Extended Mix)
Chris Rawles - I Don't Know What I'm Talking About (Original)
Andruss, Maysa - Genie
Paul Orwin - Together (Mescal Kids Remix)
Ruben Zurita - Broken Windows (Original Mix)
Adrian Oblanca - J18 (Original Mix)
Dave Azu, JJ Mullor - Jibberish (Original Mix)
Athea - Mind Game
Bronx Cheer - She Don't Mess (Original Mix)
Carl Cox - Dr. Funk (Riva Starr Mo' Funk Mix)
Myles Diverse - Twelve Heads (Original Mix)
Dario D'Attis - Little Higher (Original)
Can't Let You Go
Lap Dancers - Work That Acid (Original Mix)
Ciao Ciao My Golden Boy (Extended Mix)
Stephan Barnem - Trips (Jawoo Remix)
Mike Vale - Fuk Dat (Original Mix)
Davide Messina - Way You Move
Sharam Jey, Jean Bacarreza - Mingau (Original Mix)
Pirupa, Malandra Jr. - How Many Times (Qubiko Remix)
Danny Vibe - Im Staub Wir Vertauen (Carl Bee Remix)
The Deepshakerz - Booty Show (Original Mix)
Yves Eaux - Move On
Dave Seaman, Dario D'Attis - Gumball (Dario D'attis Remix)
ANOTR - Don't Mind Ya Weight (Original Mix)
Flashmob - Take Your Car (Original Mix)
Andre Salmon, Kricked - Faq-in Dose (Original Mix)
Pete Tong, Paul Rogers - Headstrong (Original Club Mix)
DJ Dozia - Pop Culture (KiNK Mix)
T. Tommy - El Toque
Piero Pirupa - Wanna Try (Original Mix)
Mooner Gl - Guan Yu (Original Mix)
Picca & Mars - The Rock (Original Mix)
Fred VR - Music Is Extasy
The Deepshakerz - Fly Song (Extended Mix)
Reblok - Vacancy (Original Mix)
DJ Sneak - In The Mood (Original Mix)
Ki Creighton, Makanan - Trivial (Original Mix)
Rick Grant - Spaces (Original)
Format B - The Scoop (Original Mix)
Ian Ludvig - Insane Music
Josh Butler - Sideways Acid (Kris Wadsworth's Strange Intuition Remix)
Roberto Surace - Wake Up (Original Mix)
Paul Sirrell - How To Listen To Music (Original Mix)
Saytek - In My Heart (Original Mix)
Mike Newman - Magno (Original Mix)
I'm Going Home
Mihalis Safras - Boom (NightFunk Remix)
My Digital Enemy, Lizzie Massey - To Dust (Rektchordz Remix)
Cuartero - Disarm (Original Mix)
Alvaro Smart, Jojo Angel - Bleep & Voices (Original Mix)
Roog, Dennis Quin - Get Yourself (Original Mix)
Lars Van Dalen - No Name Yet (Original Mix)
Wh0 - Sound Bomb
LucaJLove - You Know That Guy (Original Mix)
Kaiser Waldon - How You Do It (Original Mix)
Stefano Fontana - E&R (Original Mix)
Cloonee - The Ciggie (Original Mix)
Joeski - Sacred Rhythm (Extended Mix)
Denis Horvat - Minor
Marcos Arreza - Boop Bo
The Downtown Brothers - My Back Door (Supernova Remix)
Cassell - De-troit (Kreature Remix)
DJ Nanni - Enigma (Original Mix)
Ricardo Motta - Horns (Original Mix)
Gettoblaster - Work It Out (Jaceo Remix)
Rony Seikaly - Thinking About You (Original Mix)
Innerkey - Phara (Original Mix)
Lex Luca - Favourite Game (Original Mix)
Guille Placencia & George Privatti   Cha Cha Cha Original Mix
Yungness & Jaminn - Dirty (Original Mix)
Pitch Slap!
Joy Marquez - Morenita
Jack Rush - Control (Original Mix)
Sean Biddle - Freak Show (Airball Remix)
Josh Butler - Strut GTM (Original Mix)
Emeskay - My Kinda Girl (Original Mix)
Strinner - Doodle (Original Mix)
Michael Hooker - Shake That, Move That, Work That (Original Mix)
Adyn - Touch Me (Extended Mix)
Alaia & Gallo - Sunday Morning (CASSIMM Remix)
Andre Salmon, K-Mack - Salmon Man
Carl Phaffa, Mike Moorish - Ohh (Original Mix)
Shiino - Get A Life (Extended Mix)
Yariv E - BOOBOO
Ben Cheel - Kitty (Original Mix)
Bassel - Danse macabre
Husko - Release Yourself
Understate - One More (Original Mix)
Fiko - Vege (Christian Hornbostel Remix)
Robba - 1988 (Original Mix)
Mike Vale - Concept of Reality
DeMarzo - Hipnotic (Original Mix)
Nuage - Soulfiction (Danism Remix)
Dorian Craft - Nameless (Original Mix)
Redshape - Dogz
Kokks & Lein - Lazy (Original Mix)
Gareth Stirling - Music Is Dynamite (Original Mix)
Stanny Abram - Everybody (Original Mix)
IAMLOPEZ - Veneno (Original Mix)
Sven Kerkhoff - Get High (Original Mix)
Paolo Solo - ¡Aja! (Original Mix)
Yenk - Basement
Fatima & Jerome - Pigeon From The Hood (Original Mix)
Leo Aguiar - Blow
Jamie de Von - Let Us Commit (Tonix Remix)
Javi Bora - Nights Of Groove
Christian Patti - Sinapsi (Original Mix)
Herr - Trainspotting
Luis Junior - Energy Success
Milos Pesovic - Improbable (Original Mix)
Najwars - Lectio Brevis
Richie Blacker - Poltergeist (Original Mix)
Sovax - Apache (Original Mix)
Julian del Valle - August (Original Mix)
Hubinek & Sperbel - What A Morning (Official)
Joseph Edmund - Norrr
Melanie Ribbe - Bluray (Extended Mix)
Steve Lawler - Feelin
Dale Howard - Basement Groove (Wade Remix)
DJ Susan - Nexus
George Smeddles - Freak (Timmy P Remix)
Fran Bortolossi & Eduardo Drumn - Fear & Loathing (Karl Frampton Refix)
Tetchy - Sound Therapy (Original Mix)
Bruce Leroys - Cassette Tape
The Mekanism - Acid Love (Original Mix)
David Hat - Bochorno (Original Mix)
Alexey Romeo - Like This (Original Mix)
Thomas Cerutti - Dance Machine (Original Mix)
Josh Hvaal - What Ya Need
Albert Marzinotto - Dollar Bills (Original Mix)
Shiba San & Tim Baresko 'All I Need' (Extended Mix)
Wolf Story - Just House (Extended Mix)
Javi Lopez - Check Out (Original Mix)
Diezel - Tribal Chant (Original Mix)
Mark Knight - Mona Lisa (Extended Mix)
GAPS - A World Away (Eekkoo Remix)
K & K - I Can Do It (Matteo Rosolare & Jojo Angel Remix)
Siwell - In My World (Original Mix)
The Percussionist (Bonus Beat)
DJ Dove - Sun Drenched (Original Mix)
Jack n Danny - Music Please (Original Mix)
Mene - More & More (Original Mix)
Gabriel Evoke - Open Up Your Mind (Original Mix)
Mhod - Trip To Shanghai (Original Mix)
CJ Jeff - Upside Down (Original Mix)
Grensta - Cut It Up
Adesse Versions - Raw (Live Edit)
Joeski - Uh Oh Rasta! (Original)
Dirty Secretz - Deep Down Inside (Original Mix)
Onur - Big Yellow
Montel - Get Loose (Original Mix)
Sinner & James - Down To The Ground (Original Mix)
Neculai - Feel It (Original Mix)
David Glass - Everybody's Fly (Original Mix)
Fisher - Losing It (Original Mix)
TAKE IT! (Original Mix)
Joeski - Explorations In Drum (Original Mix)
Hood Rich - Light
Andrea Giungo - Roll In The Range (Original Mix)
Danny Kolk, G-Spec - I Have A Reservation
Chris Rawles - You're Just Funkin' with Me (Original)
Mata Jones - My Extraordinary Love (Original Mix)
James Silk - Werk (Matteo Rosolare & Jojo Angel Remix)
Caitto - Ball (Original Mix)
Amorhouse - Back 2 Back (Original Mix)
Paolo Solo - Cosmic Slot Girl (Original Mix)
Jaymo & Andy George, Sidney Charles - Hip Shots (Philip Bader Warehouse Mix)
Sam Ball - Devil's Dance
De La Swing - No Rules (Max Chapman Remix)
Ugur Project - Back It Up (Original Mix)
Mario Ochoa - So High (Original Mix)
Jaymo & Andy George, Sidney Charles - Hip Shots
Harry Romero - Mother Earth (Original Mix)
Don't Resist (Original Mix)
I Loved You First
Dario D'Attis - Tribe Chant
Davide Mazzilli - In My Voice
Max Chapman, ThreeSix - Make A Move (Extended Mix)
Caravaca - Party People (Original Mix)
Hard To Find (Max Chapman Remix)
Elijah Collins - Less Deep More Jack
DJ Rose - 4 Real (Original Mix)
Noizu & Eli Brown - Inside My Head
Chicks Luv Us - She's Dead (Original Mix)
Denis Ago - Fast Trumped (Extended Mix)
Frankie BlackArt - Hit Replay (Original Mix)
Asadinho - Is That My Wig (Original Mix)
Brent Anthony - Sirens Coming (Original Mix)
Hugo Villanova - Caffeine (Original Mix)
Mark Ferrer - Intruder (Original Mix)
Ollie Viero - What U Gonna Do (Original Mix)
Bingil - Badinga
Sergio Gaytan - Idolo De Barro
The Border (Mixed)
Trittico [presented by Cirillo] - Pugnet (Original Mix)
Joeski - Same Language (Extended Mix)
Frank Storm - Tripped (Original Mix) [Crunch]
Huxley - Weirdest Green
Reeveze - On & On (Stanny Abram Remix)
CASSIMM - All Over Me (Original Mix)
DJ Iaia - Koppi (Extended Mix)
Moshem - Fantasy (Extended Mix)
Alex Raider - Jazzy Cigar (Original Mix)
Kike Henriquez - My Rules (Original Mix)
Donna Allen - He Is The Joy (Alaia & Gallo Extended Remix)
Electronic Youth - The Music (Original Mix)
Gasc, Joe Red - Tree of Life (Original Mix)
Jamie Jones & The Martinez Brothers - Bappi (Original Mix)
Anton Jay, Discoplace - Flow
THR3MIND - People In Da House
Alex Raider, Steve Moro - People (Original Mix)
Laps - Joyful Process
Mhod - Make It Better (Extended Mix)
Gian Troccoli, Lio Mass - Easy Whistle (David Aurel Remix) [SK170]
Dosem - Expression (Original Mix)
Chris Rawles - Disco Dancing (Original)
Paride De Biasio - Neither Black Nor White (Original Mix)
Emanuele Inglese - Arabian (Extended Mix)
Pushkarev - I Know (Original Mix)
Savannah (Original Mix)
Cozzy D - Meerkat (Original Mix)
Fancy Inc - Our House (Original Mix)
Ray MD - La Noche (Original Mix)
Carlos Mantilla - Shame On You (Original Mix)
No Pants Party - Out of Control (Vanilla ACE edit)
Luis Ormeño - Hot Looking Babes (Original Mix)
Weikum - Move Your Soul (Original Mix)
Harry Romero - Freeway
CamelPhat - The Quad (Original Mix)
LucaJLove, Bradii - Who Really Knows - Original Mix - Paul's Boutique
Paolo Martini - Blackness (Original Mix)
Jeremy Bass - Zambia Chant (Extended Mix)
Lupe Fuentes - Let It Feel Alright (Original Mix)
Sebastian Ianno - Cosmic Chemistry (Original Mix)
Trimtone - Walkin (Original)
Neslo and The Firebirds - Movin On (Olsen Remix)
Gettoblaster, Stephen Granville - Be A Freak (Hatiras Remix)
Angel Heredia - Better (Original Mix)
Lee Mayjahs - Sumeria
Salvatore Bruno - Destiny's Wild (Original Mix)
Kid Culture, El Mundo & Satori, Kid Culture, El Mundo, Satori - Gotta Help (Mendo Remix)
Dillon Nathaniel - Do It Again (Original Mix)
Jesse Perez - Fake (Steve Lawler's Fakin' It Remix)
Stanny Abram - Margaritaville
Luca Bisori - Calling (Original Mix)
Nacho Scoppa - Mad Drummer (Extended Mix)
Bekim Rexhepi -Lamtumire oj bote ( Gezuar 2019) Topestrada Tv
Daoud - Bassline (Original Mix)
Sahib Muhammad - No Set Beat (Main)
The Deepshakerz - Penguins
Alex Ranerro - Swell (Original Mix)
Jhothi - Electric Time (Original Mix)
Codes - SOS (Original Mix)
Loosing Control (Original Mix)
Sierra Sam - Residue (Original Mix)
Bart Skils - Burnin' (Nicole Moudaber Remix)
DJ Nanni - The Drum (Original Mix)
Lonely Boy - Don't You Think (Bengal's Mojave Mix)
QT-HIGH - Turbulence (Extended Mix)
Michael Bibi - Lemonade (Original Mix)
No Name (IT) - Id (Kill My Bra!) (Extended Mix)
DeMarzo - Untouchable (Tapesh 909 Remix ) Unreleased
Markus Homm - Clear Cut (Joris Voorn Edit)
Daniel Steinberg - Perfect Day
Walker & Royce, Sophiegrophy - My Own Thang (John Tejada Remix)
Doorly & Cajmere feat. Dajae - Its About The Music Man
Roger Sanchez - Again (DJ Dep Extended Remix)
Coqui Selection - Selecta (Original)
Jay de Lys - Sexual Healing
Give It 2 Me Baby (feat. Subcquence) (DJ Soulstar Remix)
Amorhouse, Tonix - You Turn Me On Remastered (Original Mix)
La Fleur - Orbit
Callahan - Redux
Rendher - Flavor (Original Mix)
Brett Gould - Hearing Purple (Original Mix)
Fomalhaut - Rock Don't Stop
Vanilla Ace - Only Time (Original Mix)
Santiago Mendez - Are You Ready (Original Mix)
DjaimZ - The Bronx (Original)
Boris Ross - 808's & Weekends (Original Mix)
Riva Starr, Fideles - The Superdope
Prok & Fitch & Filthy Rich - Justified (Original Club Mix) [Toolroom Records]
Talamasca @ Fantastic Festival 2015 Ommix Mexico
Scotty Cal - Mothership (Olsen Remix)
Jozik - Da Da Den (Original Mix)
Alain Fanegas - Show Me What It's Like (Original Mix)
YORY - In Exsistence Vol.2 (Original Mix)
NightFunk - On The Low feat. RAEJMQ [Repopulate Mars]
Saytek - Crux (Extended Mix)
Sonny Fodera - Back This Groove Up
Alvaro Vela - Bardulia (Original Mix)
Dany Deep - Aborigen (Original Mix)
Hector Couto - Parental Advisory (DJ T. Remix)
Richie Blacker - Crayon Muncher (Original Mix)
Haste Midi - Prisoner Of Words (Maximiljan Remix)
Sankuh - Clap Yo Hands (Original Mix)
Davide Mazzilli - DiscoTech (Original Mix) [REFILL MUSIC]
Javi Lopez - Rock The Beat (Original Mix)
Fires - Rush (Original Mix)
Paul C & Paolo Martini - I Believe (Original Mix) [Snatch! Records]
Old Fat Jacko - Keep On Rocking (Original Mix)
Theo Kottis - It Wasn't Meant to Be (And.Id Rave Nostalgia Remix)
Diego Lima - Move Da Rawzz (Original Mix)
Dusky - Lydia (Original Mix)
No Hopes - I Wanna (Christian Vila Remix)
Technasia - Bring It Back (Extended Mix)
Sante Sansone - Chacha Dance (Original Mix)
Ryno - Y' All Need Jesus
DJ Oliver - Equality (Original Mix)
Dark Walls (feat. Lazarusman) (Steve Bug Remix)
Luca Gurini - Rush (Original Mix)
Majesty - Down Pour (Original Mix)
Toka. - Tropika (Toka Remix)
Redux Saints - Higher (Extended Mix)
SYAP - Go Up (Original Mix)
Paul Mag - The Siren (Original Mix)
Marc Ross - Whenever (Original Mix)
Jesters - Shake app (Original Mix)
Emanuel Satie - Now You Know
Body Freak (Original Mix)
Dj Burlak & Danny Slim Ft. TT Johnson - DNA ( Original Mix ) WU048
Ron Carroll - Walking Down the Street (Ruben Mandolini Remix)
Tommy Bones - Drop (Original Mix)
Ruede Hagelstein - Big Bang
Luca M, JUST2 - Acid Ghetto (Original Mix)
Steal Tapes - Hyper
Felipe Michelin - Smoking (Original Mix)
Kinnerman - Horns & Hats (Original Mix)
Rich Pinder - Danza (Original Mix)
Fran Guzman - Spanish Guitar (Original Mix)
Dead Celebrities - Cooking Sushi (Original)
Samuel Dan - Seny (Traxsource Exclusive mix)
Tomas Bisquierra - Apologies (Original Mix)
Klangfamilie - Santiago 1010 KHz
Jay Haze, Big Bully, Sven VT - Soul in a Bottle (Emanuel Satie Remix)
Shiba San, Kevin Knapp - Your Mind (Original Mix)
Sante - Dusty Roads
Femme En Fourrure - Dirty Blonde (Madkids Dub)
Do Santos - Only Bass (Original Mix)
Dan Rubell - Keep Going
Waitz - Dont Stop
Harry Romero - From The Root (Extended Mix)
Rodrigo Melo - Into The Groove (Original Mix)
PAWSA - Obsession (Extended Mix)
Vanilla Ace, Ordonez - The Bomb (Extended Mix)
G-Mode - Elements (Original Mix)
Martin Ikin - Bad Young (Original Mix)
Hot Since 82 - Make Up
Lex Loofah - The Warning (Original Mix)
Dakap - Ledge Game (Original Mix)
Piem - I Got the G (Bedran. Remix)
Pierre Codarin - First Date (Original Mix)
Marc Fisher - The Weather (Original Mix)
Ilary Montanari - I Believe
Marc Throw - Dark Horse (Original Mix)
Igor Project - Beat Drums (Original Mix)
Nicola Brusegan - Lobos (Original Mix)
Fabio Salerni - Bus Driver (Original Mix)
Dilby - Woyaya (Original Mix)
Housekeeping - Streetsweeper (Max Chapman Remix)
Fritz Carlton - Try (Original Mix)
Underwears
Marc Bach - Functional (Original Mix)
Jared - Just Overnight
Dennis Franchi - Rituals
Lenn & Lexx - Splitminds (Original Mix)
DJ Lucerox - Boricua (Techplayers Remix)
George Smeddles - Just Playing (Original Mix)
Daniel - Grubby (Original Mix)
Spacefunk Dub - Azuro Eleganza (Original Mix)
Bryan Estefani - Dubalub
Moshem - Funked (Original Mix)
The Machine - La Jongla (Original Mix)
Nick Olivetti - Looping Machine (Original Mix)
Deep Water
Inland Knights - I Want I Need (Junior Gee Remix)
Alex Roque - Let's Work (Squicciarini Remix)
Erik Hagleton - Arro
Alex Vero - You Get Down (Original Mix)
Pirupa - Bless The Rain (Original Mix)
My Feelings (Original Mix)
No More Sorrow (Extended Mix)
Maxinne - Outta My Head
Rodrigo Melo - Groove Station (Original Mix)
Taster Peter - Porno Totale (Samuel L Session Remix)
Sander Dellariva - Stab Jam (Supernova Remix)
CASSIMM - Dark Beat (Addicted To Drums) (Extended Mix)
The Martini Bros vs. Human League - Big & Dirty vs. Things That Dreams Are Made Of (King Unique Mix)
Mambo Brothers - Momento (Original Mix)
Sammy W, Alex E - That Thang
HAYNES - Coup (Original Mix)
Michael Bibi - Be Mine (Original Mix)
Aminix - Game Plan
My Cat Snoop - Synchronise (Original Mix)
Kike De Anda  - Circus (Original mix)
Flapjackers - Milacek (Ramon Tapia Remix)
Alaia & Gallo - Triple X (Original Mix)
Demuir - Bitch, U Gotta Work (Original Mix)
Sante - 909 Basement
Yousef - Riches To Rags (Alex Kennon Remix)
Belocca, Tobi Kramer - Be Rockin
Raffa FL - Envious (Original Mix)
Kristin Velvet - Dangerous
Italobros - Revers (DJ Simi Delirium Dub Mix)
Quell - DO IT ALONE (Original Mix)
Watchin' Out
Nick Curly - Trick Nuts
Ramin Rezaie - Horde (Original Mix)
Gabe, Dashdot - Falling (Original Mix)
Solardo - Give Yourself Up (Original Mix)
Joeski - American Poem (Original Mix)
Luke Mac - Better Have My Money (Original Mix)
Deeper Purpose - Roll Up (Original Mix)
Dimo - Can U Handle (NDKj Heatflow's Remix)
Tony S - Rorschach (Scott Harrington Remix)
Kaily - Get Ready (Original Mix)
Ezequiel Asencio - Tornado
Santo Arrosa - Mozambique
Gangsta Groove (Original Mix)
Mr. Lekka - Bouncer (Original Mix)
Antonio Pica - Friends (Original Mix)
Hira - Jack Move Your Back (Club Edit Mix)
Volkoder - I Go (Mike Vale Remix Traxsource Exclusive Mix)
Off Key - Nobody Say (Original Mix)
Solarc - The Spell (Who Else & Anhauser Remix)
Matt Sassari - Prison Song (Original Mix)
Toochi (SA) - Drop a Line (Original Mix)
Alex Twitchy - Disaster (Original Mix)
ANOTR - Hypnosis (Original Mix)
Jon Flores - The Believer (No Voices Mix)
Mark Knight - In The Other Pocket
DJ PP - El Recreo (Mario Ochoa RMX)
Volkoder - Share (Original Mix)
Dateless - The Shakery (Original Mix)
Alberto Segador - My Own Thing
Douse - First - (OUT NOW)DEEP HOUSE!!
Joe Grossman - Rugged Rhythm (Original Mix)
TAURI - Rubber
Ruben Zurita - Circo Loco (Original Mix)
Dmitri Saidi - Suck My Beat
Illyus & Barrientos - Let's Go
Billion - Party Time (Original Mix)
Jey Kurmis - Lil' Nic French (Original Mix)
Alya (FR) - Feelin' Good (Original Mix)
Step Aside (Max Chapman Remix)
The Midnight Perverts - Rover (Original Mix)
That Kid Chris - Work That (D-Formation Remix)
Alex Twitchy - Just Chill (Original Mix)
ToyGUN - Transitions (Gorge Remix)
Fisher - You Little Beauty
Greeko - Str8 Outta Club (Original Mix)
Fer Dina - Stratosphere (Original Mix)
Oscar L - My Little Dog
The Spectaphiles - Echoplex (Christian Hornbostel Cut)
Panic! At The Disco - High Hopes (Official Video)
Paul Shout - Panama (Stanny Abram Remix)
Vangelis Kostoxenakis - I Think You're Freaky
The Golden Boy - Street Right (Original Mix)
Onno, Okain - MP Scene
Midland People - Groove On (Radio Edit) [CMS158]
Mike Catherall - Buggin' (Original Mix)
Philip Bader - Keep Ya Head Up (Original Mix)
Simon Mattson - Showroom (Pele & Shawnecy Remix)
Tim Andresen - Disco Dancer
No Artificial Colours - Bounce (Original Mix)
Will Taylor (UK) - Nobody!
Michel de Hey - Baby Be Mine
Theo Kottis - UFO
Hermanez - The Lovers
Riva Starr, Green Velvet - False Claim (Original Mix)
Kokks - Fresh Stuff
Alvaro Smart, Diego Lima - Breakdancers (Extended Mix)
Miguel Picasso - Let's Talk About House (original)
EROZ, Alessdy S - Latinas (Original Mix)
Gianni Ruocco - Trick (Original Mix)
5prite - Beatstreet
YOLANDA BE COOL & STEFANO RITTERI in the Mixmag Lab
MizterRab - Fuck your Bassline (Original Mix)
DJ W!LD - Realness
PushPull - Thank You (Original Mix)
Jaceo - So Fly
Westray - Rock The Disco (Original Mix)
Lars Horton - Scraping
Sinisa Tamamovic - The Drums
Richy Ahmed - Star Wars
Cloonee - Pop It (Original Mix)
Moscrop - LFJ (Kenny Summit NSFW 1994 Vox Version)
The Deepshakerz - Everytime (Original Mix)
Gene Farris - New Jack City
Used Disco - Snatch (Sanchez & Narvaez Remix)
David Grant - Doughball
Dantiez - Carpe Diem (Extended Mix)
Squicciarini - Hold On - Original Mix (Progrez)
Rafa Barrios, Le Vinyl - Zwarte Tulp (Original Mix)
CASSIMM - We Want This (Original Mix)
Sllash & Doppe - I Want You Too (Original Mix)
One Time (Original Mix)
Kennedy - Bang The Box (Original Mix)
Music (Original Mix)
Stanny Abram, RAMA7, ABRAMA7 - 1991 (Original Mix)
Alvaro Smart - Play together (Original Mix)
Clouded Judgement - Governed By The Beat (Original Mix)
Dom Dolla - San Frandisco (Extended Mix)
Marco Corvino - Break Out (Original Mix)
Ikaz Boi - Hun! (Original Mix) [CUFF FREE DOWNLOAD]
Rick Silva - Jacking (Original Mix)
Pinco - Rush (Original Mix)
Dan Mckinley - Wan Chai (Original Mix)
Samuel Dan - Sample Loops
Vangelis Kostoxenakis - Fantasy Girl
Electronic Youth - Give In (Original Mix)
Giuseppe Raimondi - Zulema (Pierpaolo Cricenti Rework)
Eli Brown - Way Of The Underground (Original Mix)
The Butcha - More Bugged Out Please (Original Mix)
Fernando Campo - Betty (Original Mix)
Nereo - Keep On (Original Mix)
Darlyn Vlys - La Fuite (Original Mix)
JD Mals - Get 2 Miami (Jenya Melnikoff Remix)
Guzzk - Back (Original Mix)
Riky Ild - Ray Is the Seller (Extended Mix)
Roberto Surace - Joys (Nic Fanciulli Club Re-Edit)
Rich Pinder - Melodies (Original Mix)
Juliet Sikora -  Let Me Think
Fabian Argomedo - Jet (Original Mix)
Rogue D - Chains (Patrick Topping Remix)
Scratch (Enrique Gongora Remix)
Timid Boy - Der Parade (Hollen Remix)
Stan Garac - Disco Shit
Jack Back - (It Happens) Sometimes
Daniel Bracket - Samburu Tribe (Original Mix)
Davide Mazzilli - Disco - (Original Mix)
Hector Couto - I Feel You (Extended Mix)
Moreno Pezzolato - Lose My Breath (Kevin McKay Extended Remix)
Soul Speech - Soul Speech (Original Mix)
Saul Antolin - Mai (Original Mix)
Thomas Gold - Kananga (Original Club Mix)
Marc Vedo - Underground (Original Mix)
Roberto Surace - Wishes (Extended Mix)
Mindek - Genesis (Original Mix)
Moreno Pezzolato, Octahvia - U Want Me Feat. Octahvia (Qubiko Remix)
The Deepshakerz - Keep Pumping
Joy Marquez - Maniak (Original Mix)
Beki M - Back & Forth (Original Mix)
Max Hebert - Ghetto Heaven (Mikey V Remix)
Thodoris Triantafillou, DJ Freespirit - In My Key (Original Mix)
Loonic - A-Groove (Sharo Remix)
Jake Hoot feat. Kelly Clarkson - I Would've Loved You (Official Music Video)
RIDNEY - Raver (Official)
Luca Bisori - It's Cool
Ego Valente - Owned!
KI Creighton - Be Yourself (Original Mix)
Nereo - Raw Groove
Alvaro Smart - Kool 96 (Original Mix)
Dayne S, Ante Perry, IMYD - Veraloga (Tube & Berger Remix)
Toni Vilchez - Sumba E (Original 79 Mix)
Ron Costa - Pisah
Paolo Solo - I Don't Know (Original Mix)
The Best Tech House 2020-2021.Mixed by Dj FoX
Eric Louis - Into The Groove (Original Mix)
Paranino - Laboota (Club Mix)
Simon Adams - 1974 (Nicola Brusegan Remix)
Carnao Beats - Sex Talk (Original Mix)
Mark Smedley - Audio Love (Original Mix)
Chus & Ceballos, DJ Chus, Pablo Ceballos, Rafa Barrios - Now or Never(Feat. Cari Golden) (Original Mix)
Jamie Roy, Jay de Lys - Something - Sosa Remix
Erick Morillo, Jamie Jones, Gene Farris - Medication (Harry Romero Extended Remix)
Aday Chinea - Back To The Floor (Synth Version)
James Meid - Deeper Love
Roberto Palmero - Seruman (Original Mix)
Los Donatos Organos - Cab Driver (Original Mix)
Gloria best moments - Modern Family
Piero Scratch - Delicious (Extended Mix)
James Wyler - Ready (Original Mix)
FreedomB - Nane (Original Mix)
Davide Toschi - Dystopia (Original Mix)
Fake Self - My Request (Original Mix)
Folgatto - I Gotta Be (Original Mix)
Reset Safari - Drunk Dub (Original Mix)
Mason Collective - Wifey
Jeremy Bass, Branchie - La Bomba (Original Mix)
Mihalis Safras - Street Lights (Extended Version)
Karsten Sollors - On the Beat
Andrew Meller - Born Slippy (Reincarnation Mix)
Project AKC - Tacocat (Original Mix)
Steve Lawler - People Having Sex (Hector Couto Remix)
Fede Moreno - Jeffers Slims
Dario D'Attis - Bogaloo (Original Mix)
Darius Syrossian - Give You Some (Dub Mix)
Acid Electronic (Edit)
The Oddictions - Can You Feel Me
Monoky - Enough
Ramit - Save Me (Original Mix)
Matthew Codek - New Young Talent (Original Mix)
ANOTR - Keep On Breathing
Jamie Trench - It Never Stops (Chris Carrier Remix)
Renaud Genton - Brooklyn Sound (Original Mix)
Dvit Bousa - Noise (Original Mix)
M.A.L.D.I.N. - Feeling (Original Mix)
Javi Lopez - I Am Underground
May Mix, Techno Melodic 2017. (Soul Button, Himbrecht, Oliver Koletzki...)
Marcelo Vak - I'll Be Good (Mad Morello Remix)
Eren Erdol - Falling (Joeski Remix)
Hector Couto - Salimo
Allex Bridge - Itswellyah! (Original Mix)
Vangelis Kostoxenakis - All In
Groove Salvation - Hold Your Head Up (Original)
Sante Sansone - Keep Movin' (Original Mix)
Loco Dice - Roots (DJ Tennis Remix) [DESOLAT075]
Renaud Genton - Good Old Days (Original Mix)
Kwal - You (Original Mix)
Erick Morillo - The Edge (Vocal Mix)
Trent Cantrelle - Come On Baby
DJ Lugo   Hooka Original Mix
Clan EQ - Muddy (Original Mix)
Reblok - Babylon (Original Mix)
Siege - Thinking (Original Mix)
Mark Farina - C'mon Playa (1200 Tech Mix)
iPagan, System Efe - Direct Current (Original Mix)
Deeplotronic - House Store (Original Mix)
Come To My Room (feat. Leela D)
KninoDj - Set 437 - Tech House
The Deepshakerz - Right Stuff (Original Mix)
Ron Carroll - Lucky Star (Mike Vale Dub Remix)
Crazibiza - Cali Soul (Extended Mix)
Monello - Distortion (Original Mix)
My Cat Snoop - Repeat (Original Mix)
Jonatas C - Back To Bass (Original Mix)
Marco Feel - Sleep No More (Original Mix)
Alvaro R - Hamilaia Funk (Original Mix) [House]
Satori - Umama (Riva Starr Remix)
Roland Clark, Sante Sansone - House Nation (Riva Starr Edit)
Tiger Stripes - Spirited Away (Ian Ludvig & Joe Red Remix)
Martin Ikin - Rockin Beatz (Original Mix)
Di Chiara Brothers - Black Chan (Original Mix)
On and On (Original Mix)
Kevin  TwuosiX - Sweet Love(Original Mix)
Solardo - Matador (Original Mix)
Beat Dancer (Original Mix)
Denique - Around Underground
Hansol - Take Me Back
Josh Butler, SOHMI - Sunday Sunset (Original Mix) 444 Hz
Rio Dela Duna - Pedalo (Dany Cohiba Remix)
Tribavenue - Liberia
John Roberts - Freaks (Harry Romero Remix)
[TVRD116] Flippers & DJ Slater (feat. U-Prag) - Unlocked (samples)
Dope Dog - Keep House Unda'Ground (Mosca's From The Vaults Version)
Audiophonik - Lose My Soul (Original Mix)
Joe Smooth - Promised Land (Erick Morillo Extended Remix)
The Deepshakerz - I Got To Show You (Original Mix)
Patrick Topping - Free Admission (Original Mix)
Vlada Asanin - Can't Help It (Original Mix)
Stefano Noferini, Larsen Factory - Your Hands Up (Chus & Ceballos remix)
De La Maso - Bad Boy Scream (Original Mix)
Denney - Serenade (Joeski Remix)
LouLou Players, Classmatic - Baseline (Original Mix)
Waitz - Wikki (Original Mix)
Davide Mazzilli - Realy Hot (Original Mix)
Andruss, Dmitri Saidi, DHAF - In The Ghetto (Original Mix)
Baunzz! - Man From Fula (Stanny Abram Remix)
Francis Kasibante - Bass Face (Original Mix)
Must - Perfect (Original Mix)
Jon Flores - Crazy Tribal (Original Mix)
Iglesias - Purple Sky (Original Mix)
Tucci - Let Me Escape (Original Mix)
Amorhouse   To Be Free Extended Mix
Hector Couto - Lil Old Man (Original Mix)
Deal with Uz (Daniel Rateuke Main Remix)
Russ Yallop - Sensation (Original Mix)
Dimmish - Riddle (Original Mix)
Moreno Pezzolato - Hysteria (Original Mix)
Siwell, Mary Klare - Good Times (Extended Mix)
Onno, Marcus Gehring - Elephant in the Room (Original Mix)
Milldyke - The Underground (Original Mix)
Namesake - Pear Shaped (Original Mix)
Servante - Mr. Bliss
Waze & Odyssey, Greed - Pump Up the Volume (Waze & Odyssey vs Greed)
No Hopes - FY (Original Mix)
Waifs & Strays - You Decide (Original Mix)
Cristian Poow, Glovibes - Shake Ur Bumpa (Original Mix)
Ronnie Lopez - Soundboy (Original Mix)
Astronomar - Navy Cheeto
Elektro Guzzi - Atlas (KiNK Mix)
Drunky Daniels - Mr.Spice (Original Mix)
Chicks Luv Us - Acid Monday (Original Mix)
Akyra - On The Bass [Original Mix] BGT016
Metodi Hristov - Massive Attack (Original Mix) [TERMINAL M]
Kellie Allen - Handle It
Mirko Di Florio - Mesmerized
Just Dennis - Do It Now (Original Mix)
Franky Rizardo - Take Off (Original Mix)
Dj Face Off - I Swear (Extended Mix)
Tobi Kramer - Te Gusta Bailar (Original Mix)
RAMON BEDOYA - Cocaine
Phuture Phunk - Shake The Floor (Original Mix)
Mikael Delta - Staunch Hearts (Dub Tech Version)
Outstrip - Kardan (Original Mix)
Matt Tolfrey - Nothing Like Home (Original Mix)
Daniel Brooks - Kumale at The Weekend (Original Mix)
MANIK - I Know (Original Mix)
Jose Vilches - Pavo real (Original Mix)
the rah band - clouds across the moon napoleon remix
Bondage Music Radio - Edition 56 mixed by Pornbugs
Dj Vivona - Black (Marco Lys Remix)
Daniel Lera - Wires
US (US), Sergy - Crushit (Original Mix)
AYAREZ - West Coast (Original Mix)
Sovax - Rule The World (Original Mix)
Apollo 84 - Space fish (Raffa FL remix)
Lewis Monbarn - Screaming Delight (Original Mix)
Sinden - Flip The Beat (Sinden Remix)
Rebuke - Along Came Polly
Jordi Marcel - Don't Stop
Moshem - Cram
Queensyze, SOLLORS - Gotta Get Up (Original Mix)
Chris Magg - The Master (Original Mix)
Hauswerks - Night Crawler (Original Mix)
Uto Karem - Utopolys (Sebastien Leger Remix)
Andrew Macari - H.o.u.s.e
Sllash & Doppe - Thrift Shopping
Francis Overcast - See You Need Me (Original Mix)
Branzei - My House
Lautaro Bidegain - Get Started (Original Mix)
Wise D & Kobe - Rhyme & Reason (Original Mix)
The Frenchies - Feel for You
Alex Kremer - New World (Original Mix)
Plastic Robots - Silent Fury (Original Mix)
Sovak - If You Want It (Original Mix)
Camilo Do Santos - Bo Bounce! (Original Mix)
Acid Mondays - Blazelnuts (Original Mix)
Jamie Jones - Danger Mouse (Original Mix)
Cuartero - Item 3000
Yade - Dystopia (Original Mix)
Francesco Poggi - Revolution
Dont Make Me (Original Mix)
Huxley - Babyface (Extended Mix)
DONT BLINK - REVOLUTION 909 (Original Mix)
Geil - Ambigue (Atapy Remix)
Moshem - The Way (Extended Mix)
84Bit - Bitches, Money, Respect! (Mr. Lekka Remix)
Alex Virgo - Somewhere Else (Original Mix)
Son Of Sam - Nature Makes A Mistake (Ame Remix)
Caravaca - Vice City (Original Mix)
Son of 8 - Party Time - Ian Jay Remix
Una Mirada (Original Mix)
Horatio - Brighton 4 AM (Extended Mix)
Fran Guzman - Gazpacho
Sllash & Doppe - We Gonna Party (Original Mix)
Blame Mate - Bounce With Me (Original Mix)
Franklyn Watts - Holdin' It Down (Original Mix)
Emery Warman, GuyMac - Automatic Black (Original Mix)
Dany Cohiba - The Ring (Original Mix)
Robin Fett - Street Groove
Tuesdays (Original Mix)
Nhan Solo - For The Groove
Motel Express - Automobile (Original Mix)
Roter & Lewis - Bassman (Original Mix)
Maher Daniel - Here &There (Original)
22 Weeks - Trying To (Original Mix)
Caravaca - Bye Bye (Original Mix)
Robert Dietz - Radio Raheem
DIMO(BG) - One Day Baby
Digital Pony - Drooom
Kevin G - Just Another Groove (Vincent Villani Remix)
Tony Metric - Moves (Original Mix)
Westend - Ya Feeling Me
Aumrec - Steamground (Yves Eaux & Ruslan Cross Remix)
Luke Wheeler - I Get It (Original Mix)
IDQ - Rebels (Josh Butler Extended Remix)
DC Dubz  - Resistance (Original Mix)
Max Chapman - Gritty (Original Mix)
Demarkus Lewis - Burn It Down (Johan S Remix)
Lass (FR) - Sensation (Extended Mix)
Vincenzo D'amico - Metro Tap (Original Mix)
Magic Place - Don't Stop (Original Mix)
Berlak - Vazilando (Original Mix)
Mauro Venti - Plug World (Original Mix)
Oscar Cano - El Che (Original Mix)
Christian Dehugo - Mumbastik (Original Mix)
Simon Kidzoo, Havoc & Lawn - Falling (Original Mix)
Maddiman - Connected - Loulou records (LLR238)
Damiano C, Harper, Yulia Niko - High & Low (Extended Mix)
Max Holtey - All Night (Bedran Remix)
Salvatore Bruno - Knightrider (Original Mix)
Ammo Avenue - Catharsis (Original Mix)
Mr. Kavalicious - Deep Inside (Original Mix)
MJ Cole - Alcatraz
Wheats - Lady Kristine
Mikel Ayerra, Javi Colina, Quoxx - La Marimba
Circuito Zeta - Get Fooled
Haus Side - Fyah Dance (Original Mix)
Chemical Surf - Don't Be Jealous (Original Mix)
Javi Lopez - Kiss Me Twice
Kydus - We Own the Night (Original Mix)
Kennedy - Should You (Dilby Remix)
Johan S - Find Love (Extended Mix)
Ultra PoP - Hypno Dance (Original Mix)
Keizer Jelle - Chonker (Extended Mix)
5prite - Doin It (Original Mix)
Nofex - My Love (Original Mix)
Fuzzy Hair - You Give Me Everything (Extended Mix)
Piero Pirupa - Da Muzik (Original Mix)
Havana Dub, Marck Jamz - Cause & Effect (Original Mix)
James Dexter - Beneficial Effects (Original Mix)
Francisco Allendes - Inca Roads (Original Mix)
CamelPhat - Arabella
Saeed Younan - What Was
Best Of Tech House 2020 By Mario Bocca On TOPradio (BE)
Francesco Tarantini - Rebound (Original Mix)
Javi Lopez - Black Sequence (Lupe Fuentes Remix)
Vidaloca, Piem - Start The Show (Original Mix)
CASSIMM - Work Out (Extended Mix)
Josh Lee - We Belong (Original Mix) [Hungarian Hot Wax]
ALBT - Say Yes (Original Mix)
Mendo - Lemonade (Extended Mix)
Salamanda - That Girl (Original Mix)
Massimiliano Pagliara - I Am Running All My Drum Machines At Once and Dancing
Solomun - Zora
Paul May - Learning To Fly (Original Mix)
M. Rodriguez - Bring Da Drums (Original Mix)
Anek, Medusa - We Are
Rework - Blackout
Absolut Groovers ft. Master Freez - Do The Cha Cha (Tradelove Remix)
Kastis Torrau - Safari Horizon (Original Mix)
Hardynoises - Huget (Original Mix)
BRADII - Need U (Original Mix)
Flash Is Fast - Flange Needle
Piem - Freak Out
Sante Sansone - Catch! (Original Mix)
Yade - Just Beneath It (Original Mix)
BLAQWELL - Traveling Man (Original Mix)
David Herrero - Take The Soul (Extended Mix)
Electronic Youth - Let's Go (Nanci's Mix)
UFoS - Limitless (Original Mix)
El Pedro & Di Marino - Your Way (Softpaw Remix)
Stanny Abram - Disco Jack (Original Mix)
Chapter & Verse - Step Into It
Echonomist - Random Memory (Quell Mind Remix)
Supernova - Brooklyn Wheel (Original Mix)
Supernova - Don't Stop (Original Mix)
Oscar Cano - Palenque (Original Mix)
Mario Ochoa, Ramit - Africanism (Original Mix)
Rebute - The Rhythm (Original Mix)
Mikalogic - Cosmic Sea (Original Mix)
James Silk - ATMO (Original Mix)
Nils Ohrmann - Flour Your Nuts
Delpezzo - Saxy (Original Mix)
Daniel Frontado - Too Yop (Original Mix)
Jam Back, Robin Stope - In Control (Original Mix)
Majesty - Cissy Bass (Original Mix)
Nacho Chapado - La Musica Que Mueve (Aitor Galan Remix)
Dinamo Azari - Victim (Carl Craig Remix)
Rafa Navas - Your Not Alone (Original Mix)
Simon Adams - All U Need (Original Mix)
David Glass, Moji - Beat Freak (feat. Moji)
Waitz - Aus Swindle (Original Mix)
Nic Fanciulli - Werk (Move Your Body)
Hauswerks & Paul Cooper 'Fear & Loathing' (Original Club Mix)
Umami - RGB
Nina Perez - I Can Do It (Christian Hornbostel Remix)
Andy Bublick - Ritual Voodoo
Dan Zalot - Extra Ordinary
Ego Valente - Volcano
Ralph C - This Is House (Original Mix)
MS Pika - Some People (Original Mix)
Danny Kolk - Ahuul (Original Mix)
Tenacious - The Afters (Original Mix)
Kuestenklatsch - Groovin Dancin (Original Mix)
Rich Gior - Need Ya Back (Original Mix)
Lorenzo De Blanck - The Bump
Alessia Cara - Here (Lucian Remix)
Breathe (Freejak Extended Remix)
Pasquale Caracciolo - Let You Go (Simone Vitullo Miami Edit 2018)
ATFC - Huh Huh Huh (Extended Mix)
Understate - B2B (Original Mix)
Sasha - Out Of Time
Josh Butler - Anonymous (Original Mix)
Maxi Valvona - You Gave Me Everything (Tim Andresen Remix)
MISHQA - Gimme
Moumba (Daniel Meister Remix)
Dennis Cruz - Watch Where You Walk
Black V Neck - Ah Ah Ah (Extended Mix)
Rowlanz - TR Fate (Mr.C Superfreq Remix)
GAWP - No Warning (Original Mix)
Bnzo - Shadowtricks
Luigi Rocca, RUDE (IT) - Temptation (Original Mix) 444 Hz
ANA (Original Mix)
Renaud Genton - Let's Go (Original Mix)
Sasa Di Toma - Give On (Alvaro Smart Remix)
CJ Jeff - Wait a Second (Original Mix)
Shiba San & Green Velvet - Chance
Francesco Dinoia - Old Old (Original Mix)
Acumen, Ranacat - Orchid Simia (Gorge Remix)
Francesco Dinoia - Finger Day (Original Mix)
Deeplomatik - Love Me (Extended Mix)
Slugg - Rookie Of The Year (Original Mix) [RAWSOME RECORDINGS]
Joeski - My Guitar (Original Mix)
Tennan - Shake Off (Original Mix)
Jansons feat. Dope Earth Alien - Switch
Enzo Tucci   Blackjack Original Mix
JUST DONT PREACH ME
JP Chronic - Back at My Place
Basic Answers (Original Mix)
Dlc - Type
Golf Clap - Vices (Original Mix)
Softpaw - Deeply (Original Mix)
Kreature - Obi Wan (Original Mix)
Party With Somebody (Original Mix)
Sidney Charles - Power Of The Underground
Tovar - Rambua (Original Mix)
Timid Boy - The Jazz Club (Original Mix)
Biscits - Do It Like This (Extended Mix)
Tiga - Eye Luv U (Butch's 80's Warehouse Acid Remix)
Carlo Kopana - African Tribe (Original Mix)
Sammy W - Funky Ride (Original Mix)
Matt May - Right Now (Original Mix)
Ruben Zurita - Premonicion (Original Mix)
Geddes - Luccie
Sante Sansone - Musically (Original Mix)
Moreno Pezzolato, Kevin McKay - Touch Me (Extended Mix)
Nacho Scoppa - Urbanism (Extended Mix)
Maxinne - Outta My Head (Original Mix)
Klangkuenstler - Golden
Toni Vilchez - Arabian Story (Original Mix)
Lowell - Reggae Boy (DJ Vitto & Stefano Mango Remix)
Lucati - Ounce (feat. MKJAY)
Dj Infinet - Nuwave (Original Mix)
Grandtheft - Splash
Denis Ago - Seven (Original Mix)
Noone Costelo - Boomerang (Original Mix)
LYCID - The Message (Original Mix)
Fancy Inc - Spin That Thing (Original Mix)
Piem - So High (Original Mix)
Prok & Fitch - Tears (Latmun Remix)
Samuel Soul - What We Gonna Do (Original Mix)
Andy Reynolds - Boys from the Barrio
Extrawelt - My Stupid (Gregor Tresher Remix)
Richy Ahmed - Can't You See
DJ Nanni - Power (Original Mix)
T99 - Anasthasia (Kevin Saunderson & Dantiez Extended Remix)
Delpezzo - Dont Push Me
Jame Moorfield - The Dance (Original Mix)
Seba Machado - Cycles (Uriah Persie Remix)
DJ Nanni - Mixogroove
Fausto Messina - Pica Pica
CLESENT - Paradise (Extended Mix)
Yade - House Is A Feelin (Original Mix)
Seba Machado - Cycles (Original Mix)
John Summit - Afterhours (Original Mix)
Tony Verdu - Welcome To Bye Bye (Original Mix)
Machado Brothers - Cotilla (Original Mix)
Max Chapman & George Smeddles - Zulu (Original Mix)
Nader Razdar - Get Ur Freak On (Kevin McKay Extended Remix)
Exit 99 - My Drunk
Curtiba - Bum (Extended Mix)
Kevin McKay, CASSIMM - Love on My Mind (Extended Mix) [Glasgow Underground]
Alex AQ - Don't Break It (Original Mix)
Tenacious - Lights On (Original Mix)
Casual Villain - Snap The Power (Original Mix)
Aday Chinea - Everybody (Original Mix)
Jake Would - Pump it (Pump up the jam 2k20)
Tom Flynn - Argentina (Original Mix)
Darius Syrossian - Fugazi Land (Original Mix)
Sirus Hood - Out Of The Box (Extended Mix)
Rooke - Feedback (Original Mix)
Teddy Jiyane - Senti Drums (Teddy Jiyane Senti Drums)
Ramon Tapia - Yellow Submarine (Original Mix)
Pach DJ - Danza Loca (The Deepshakerz Main Remix)
Hector Couto - Balada De Suenos (Original Mix)
Don Rimini - Motel Ride (Original Mix)
Enzo Siffredi - Yes Indeed
PonyTech - Ejecta (Original Mix)
Mason Maynard - McLovin'
Jay Lumen - Mooovin (Original)
Javi Lopez - Extreme (Original Mix)
Jorge Cary - Change
Sharam Jey - Thunder Drums 2019 (Sharam Jey & Jean Bacarreza Remix)
Michel Talle - Lead (Original Mix)
Eli Brown - Sumatra (Original Mix)
DJ Dove - I Feel A Chemistry (DJ Shu-ma Remix)
Wise D & Kobe - Freaks (Original Mix)
Denis Horvat - Moon (Original mix)
Carnao Beats - Chain Of Fools (Original Mix)
Felipe Fella - Low Frequencies (Extended Version)
Stanny Abram - Super Villain (Original Mix)
Dany Cohiba - Sugar Land (Original Mix)
Pablo Cahn - Soul Rain (Paco Osuna Remix)
Jonas Rathsman - Cobalt
Jo Medina - Feel It
Body Worker (Original Mix)
Wise D & Kobe - Bandit Fonk (Original Mix)
Luis Pergo - Why Not (Original Mix)
Phari - Wrong Is Right (Original Mix)
Ben Grunnell - Push It (Synth Version)
Eric D - Overdrive (Original Mix)
Gemini 529 - Dat Ass (Original Mix)
Dennis Quin - Burnout
Karmon - Eleventh Hour
Davydov - Don't Need Know (Belocca Domino Dub)
Alfrenk, Greck B, Giancarlo Zara - Emotions (Original Mix)
Gorge - Tayo
Jaksan - Trabajo (Original Mix)
Qubiko - U R (Extended Mix)
Chick Iverson - Maniac
Anthony Attalla - House Nation (Original Mix)
Anton Jay - Take One (Original Mix)
Lorenzo Trapani - Huston (Original Mix)
Pigeon Busters - Monkey T3chno (Original Mix)
TWISTED MOON - Tech Mology (Original Mix)
Fran Guzman - Gangsters
Andre Salmon, J Avila - Queen's View (Extended Mix)
Danny Howard - Beat of the Drum (Extended Mix)
Piem  - Love Commandments Piem Remix
Lexa Hill - Warped
Fisherman & Hawkins - Nightshift (Original Mix)
Manolo Giuliani - Street (Original Mix)
DJ Wady - Hulk Is Back (Original 13cm Mix)
Veerus, Maxie Devine - Refurb (Original Mix)
Tennan - Last Nite (Original Mix)
Oscar Mackenzie - Fortune (Original Mix)
Dany Cohiba, John De Mark - Guaracha (Original Mix)
ND Catani - Go Deeper (Original Mix)
Moonwalk - Just you (Original Mix)
Bert Brown - Deeper Underground (Mark Faermont Remix)
Tawata - Sleping (Original Mix)
Kevin McKay - Station of the Groove (Original Mix)
Arkoss - Bam Bam (Original Mix)
LondonGround - Neon (Original Mix)
Elias Tzikas - Rotate
Alex Sosa - ILuv (Original Mix)
Collin Priest - Blushin' (Original Mix)
Elephunk - Azure (Pedro Goya & Magazino Remix)
Blu 9 - Haters (Original Mix)
Dominico - Save Me (Original Mix)
Lupe Fuentes - Check It Out (Original Mix)
Miss Sheila - The Freak Out (Jaimy Remix)
Nick Curly - Wake Me Up (Mathias Kaden's Rhythm Remix)
Pablo Say - Shayry (Original Mix)
Fabio Salerni - The Warehouse (Original Mix)
Los Donatos Organos - My Mind (Original Mix)
Jeremy Bass - Planet Nr. 4
Set Me Free (Original Mix)
Elian Dust - Into the Room (Original Mix)
Waitz - Freak (Original Mix)
Project89 - Pump It (Original Mix)
Tough Love - Platinum & Gold (Extended Mix)
Electrik Cat - It's Time (Extended Mix)
One Love
PEZNT, Mike Vale - Burek (Mike Vale Remix)
Sidney Charles - Eat My Chords (Original Mix)
Carlo Marani - I Don't Understand (Original Mix)
Reunion Ensemble - The Rhythm (Dan Rubell Rmx)
CASSIMM - I Wish (Original Mix)
Norberque - Touch To Space (Original Mix)
Sovax - Oh My God (Original Mix)
Heartik - Keep on
Rossi. - March On Rhythms (Original Mix)
Love Regenerator, Steve Lacy - Live Without Your Love (Solardo Remix)
Sammy Deuce - Kiss The Girl (Kiss The Gun Remix)
Hiva - Swing It (Original Mix)
Trav & Volta - Paradise (Luvstuff's Blade Remix)
Alex Kennon - Blue Line (Original Mix)
20 Year Cycle (Instrumental Mix)
Belocca - Street Mofo's
James The Cat - I've Got Rick Wakeman In My Basement (Stanny Abram Remix)
Markus Homm - Back At It (Original Mix)
Basement Jaxx - Fly Life (Flashmob 2018 Remix)
Detlef - Music Please
Juanito - Drop That Beat (Original Mix)
Baunzz!, Senores Funkees, Mladen Mande - Cause and the Cure (Original Mix)
Sydney Blu - Throwdown
ANOTR - Let Me Tell You (Extended Mix)
Sllash & Doppe - Gingoba (Extended Mix)
Masterboy - Land Of Dreaming (Official Video)
Guillermo Castillo - Contra (Original Mix)
Jowe X - Da Soul (Original Mix)
Miguel Tagua - Working The Tech Rap (Original Mix)
Big Miz - Break the Law
Daniel Lera - Need You (Original Mix)
Olly Davis - What You Smoking (Original Mix)
Fur Coat - U Turn
Javi Lopez - Rhythm Shot
Sonny Fodera & Biscits - Vibrate [SOLOTOKO]
Riva Starr - Ride This Out (feat. Imaginary Cities) [Biscits Extended Remix]
Hugo - Idiom02-1 (Original Mix)
J Lousat - Bright Moon (Original Mix)
Dean Mickoski, Roland Clark - Smells Like Rhythm
Camilo Do Santos - PlushBerry Ma' Nigga (Original Mix)
Jose Vilches - Live Dreaming (Original Mix)
2W Tools - Meeting In Progress
Okain, Cuartero - Cameleon (Hot Since 82 Remix)
Federico Ambrosi - Good Vibrations (Original Mix)
Luca Cazal - Telephone Call
Electronic Youth - Save The Day (Original Mix)
Robiin - Feel It (22 Weeks Remix)
Alex Raider - The Magician (Original Mix)
Christian Nielsen - Intro (Original Mix)
Danum - This House (Original Mix)
Seeward, Big Ma.Mi - Garga Me (Original Mix)
Lex Luca - Clap Your Hands (Original Mix)
Federico Ambrosi - Perspective (Picca & Mars Remix)
Maxinne - Get Up (Extended Mix)
DJ Fronter - Rambla (Original Mix)
Jack n Danny - Burn Original (Original Mix)
Julian Collazos - Michvi (Original Mix)
Spencer K, Dennis Cruz - Impacto (Original Mix)
Don Raul - Munga (Extended Mix)
Riva Starr, Dajae - Around Me (Original Mix)
Charles Ramirez - Mistery
Sergi Moreno & Jose Diaz - Groovin (Original Mix)
2000 and One - Inside Job (Original Mix)
Marco Strous - Tip Toe (Original Mix)
Kuestenklatsch - Is Now (Extended Mix)
Apexape, Carla Monroe - Whiskey & Cola (feat. Carla Monroe) (The Golden Boy 'Friends in the Booth' Remix)
Tony Gastello - Reload (Greg Stainer Remix)
AmyElle Feelings Mix 0120
Treasure Fingers - Bodyrocking (Rrotik Remix 2020)
Nick Wolanski - Chemistry (Original Mix)
Inside Out (Original Mix)
Sharam Jey - Don't Lie (Nick Curly Remix)
Sax on Move
Narson Nelson - Night
Soul Divide - Real Talk (Original Mix)
Guardate - Tech Y La (Original Mix)
Joris Dee - In My Mind (Original)
Cuiaba (Original Mix)
DAVIDE MAZZILLI - DONT STOP - (Original Mix)
Ruben Zurita - Mad Bird (Original Mix)
Juanito - Acuerdate (Original Mix)
Used Disco - Snatch (Original Mix)
Jorge Mattos - Soul Dawn - Loulou records (LLR220)
Jimi Jules - Earl (Original)
Jonatas C - Jane (Original Mix)
Superstitious Foundation (SCP original song)
Full Intention - I Miss You (Full Intention Dub)
Dakar - Rifle (Original Mix)
BOg & Tim Engelhardt - Why Should (Original Mix) [Diynamic]
Doorly, Tan Dem, The Voice Of Mike Skinner - Tonga Peak Times (Confuse Dem) (Original Rub For The Club)
The Deepshakerz - Organic (Extended Mix)
Little Rick - One Night
Fancy Inc - Own Thing (Original Mix)
Wally Lopez, Cevin Fisher - Don't Stop Feat. Cevin Fisher (Kevin McKay Remix)
Anthony Attalla - Rodman (Original Mix)
Chris Simon - Big Tent (Original Mix)
Simone Bica - Acid Meltdown (Original Mix)
Edwin Oosterwal, Woodie S - Missing (Original Mix)
Max Kernmayer - Get Down (Original Mix) (Daylight Robbery Records) (Tech House)
Gui Boratto - Get The Party Started
Sovax - Startin (Original Mix)
L.O.R.D.I.E - Posse (Citizenn & Jamie Roy Remix)
Dale Howard - Hands Up (Original Mix)
John Dish, Allen Wish - Domino
Yousef - Just a Beat (Original Mix)
Lewis Delay, Peter Crunch - My Rivers (Original Mix)
David Herrero - Botton Clash
Paolo Martini - Fiamma (Original Mix)
Karlos Cheadle - Rock This Place (Original Mix)
Want Your Soul (DJ Burlak Remix)
Danniel Selfmade, Tony Verdu, Charlie Demir - La Playa (Original Mix)
Metodi Hristov - Just What You Feel (Dj Wady Bedroom Muzik Remix)
Karsten Sollors - Rhythm Nation (Original Mix)
Piemont - After Glow
On My Mind
Denney - Back To Basics (Original Mix)
Alexander Vogt - Big Kahuna (Original Mix)
Piem - Morrysom
Luca Secco, Craftkind - No Chords (Original Mix)
Moonbootica, Ante Perry - Look Out
Macsan - Yellow Town (Original Mix)
Groove Salvation - Deep Minds (Original Mix)
Wexx - Dirty Girl (Original Mix)
PachangaStorm - Swang (Extended Mix)
Bart B More - Work Dat (Original Mix)
Gerome Sportelli - Deep inside (Dachshund Remix)
Richard Whistle - Cup Of Tea (Original Mix)
TyJay - Remember This (Original Mix)
Bas Ibellini - That's Right (Original Mix)
Muzzaik - Monkeydance (Original Mix)
LucaJLove - Like This (Original Mix)
Stanny Abram - Keep The Flow (Original Mix)
Lucien Foort - The Clock is Ticking (Deep Vibe Mix)
Mij Mack - Alone (Original Mix)
Tennan - I See You
Untwisted - Hot Tubes (Extended Mix)
Yvan Genkins - Ying Ying (Extended Mix)
Vangelis Kostoxenakis - I'm Ravin (Original Mix)
LucaJLove - Magnetic (Original Mix)
Ruben Zurita - Underground Deep House
Mark Knight - Devil Walking (Original Club Mix)
Wrighteous - Beyond the Drums
Dj Kone, Marc Palacios - Up Together
Dany Cohiba - Candeal
Boxia - Biology (Original Mix)
Doc Brown - Heartbeat
Love Regenerator, Steve Lacy - Live Without Your Love (Solardo Ball Bass Remix)
Love Connection
Fabian Argomedo - True or False (Original Mix)
Voices (Original Mix)
Simon Garcia - I Never Knew feat. Trisse Young (Original Mix)
Cosmicfellas - Space Travel (Original Mix)
Qubiko - Know Me (Extended Mix)
David Herrero - Tierra (Original Mix)
Sven Tasnadi - This Girl (Nick Curly Remix)
F-Man - Scratch Today (Extended Mix)
Max Chapman, Pirate Copy - Call The Police (Original Mix)
Rick Silva - Work It (Original Mix)
Sllash & Doppe - Freak On (Original Mix)
Electrik Cat - Basslines (Electronic Youth Remix)
Lander B - Core (Original Mix)
Jose V - El Miura
Lowjess - Blessed (Extended Mix)
Sirus Hood - Warning (Original Mix)
Richy Ahmed - Jammin' (Josh Butler Remix)
Luca Secco, Craftkind - So Cool (Original Mix)
Marc Ross - Hello (Original Mix)
Marc Ross  - Siria (Original Mix)
Phun Thomas - Conscious Flow (Runemark Remark)
Cassy - All I Do (Ron Bacardi remix)
Chiqito - Bass Down (Original Mix)
Rich Wakley - Time to Jack
CamelPhat - Monsters (Original Mix)
Tucci - Evangelion (Original Mix)
Illyus & Barrientos - The Ruler (Original Mix)
Solardo -  Matador
I Can Feel (Original Mix)
Mihalis Safras - Power (Original Mix)
Belocca - Tear the House Down (Original Mix)
Shiino - Take Me Down (Extended Mix)
Nice7 - Running Man (Latmun Remix)
Stace Cadet - The Circus (Extended Mix)
Moshem - Space (Extended Mix)
Emanuel Satie - One Love
Green Velvet - Flash (Eats Everything Remix)
Ismael Casimiro - Trato
Mihalis Safras - Boom (Bassel Darwish remix)
KPD - Industry Destroys (Original Mix)
Cozzetto, Willis - Freak Out
Jamie Porteous - Burtons Garden (Original Mix)
Robiin - Short Man (Original Mix)
Gorgon City - Roped In
Walker & Royce - Fetish (Original Mix)
Rodriguez Jr. - Bittersweet
Harvey Wallbanger - Anonymous Outrage (Original Mix)
Ananda Project - Ménage à Trois (Mr. Terrible Bits 'N Pieces Remix)
Dashka - What To Do (Original Mix)
The Ger-Man - Get Wild! (Extended Mix)
Joyce Muniz - Party over Here, Party over There (Homework Remix)
Dan Mckinley - Get Me Higher (Original Mix)
David Glass - Like a Pro (Original Mix)
Reinier Zonneveld - Spacedge
Nathan Barato - Can You Hear Me (Original)
DJ PP, Jack Mood - If You Fall
Deeplomatik - Slow Down (Extended Mix)
Lawrence Friend - Nobody Else (Extended Mix)
Saccao, Anturage - Age Of Revolution (Original Mix) [Audiomatique]
SnoDay - Move It (Original Mix)
Nino Bua - Pump Up The Ballz (Original mix)
Luca Guerrieri - Neptune (Marco Lys Remix)
Darius Syrossian - Bull Stomp (Phil Weeks Ghetto Dub Remix)
KineZzz - Great Run (Original Mix)
Steve Kid - Girlfriend Traps (Original Mix)
Ismael Casimiro - Toy Music (Kevin McKay Remix)
Chab Nabouchu - Hyperactive (Original Mix)
Ismael Rivas - Is Hot (Original Mix)
Dario D'Attis & Shyam P - Misleading (Vocal Mix )
Charles Ramirez - Distraction
Latmun - Funky Drummer (Original Mix)
Alex Roque - Soul Train (Level Groove remix)
Mirko & Meex - Like This (Extended Mix)
Pinco, Juan (AR) - Move Like That (Original Mix)
Adrian Scarlett, Josh Reguer - La Arbolada (Original Mix)
Cosme Martin - Afrodita (Original Mix)
Max Esposito - Deep (Original Mix)
Nice7 - Turn Off The Lights (Club Mix)
RSPK - Kone (Original Mix)
Pimpo Gama - Let's Play It Again (Original Mix)
Robiin - Crazy Trip
Ayman Awad - Free Your Body (Original Mix)
Mauro Venti - Rhythm
Stanny Abram - Wicked (Original Mix)
Spuri - Last Way (Original Mix)
Electronic Youth - Detuned (Original Mix)
Groove Killah - Troubleland (Original Mix)
84 Avenue - Timbao (Original)
Stanny Abram - Thank You (Original Mix)
Antranig, Rony Seikaly - Le Freak (Original Mix)
Jean Pierre, The Martinez Brothers, Jesse Calosso - The Shuffle (Vocal Mix)
Joeski - Hey Fellas (Original)
Mike Denitz - Biscute (Original Mix)
Lander B - My Face
Cup & String - Baby I'm Waitin (2018 Mix)
Sven Tasnadi - Unoma
Marshall Jefferson x Solardo - Move Your Body
Alex Twitchy - Check This Out (Original Mix)
Ivan Luceri - Free Rhythm
Lexa Hill - Know It's Love (Extended Mix)
Noboa - Bongoloid
Javi Bora, Iban Montoro, Jazzman Wax - Block Party (Original Mix)
Illyus & Barrientos - Scream (Original Mix)
The Lion Brothers - Move Your Body (Original Mix)
Hatiras, Lee Wilson - I Just Can't (Espinal & Nova Remix)
Martin Ikin - Pulse Wave (Original Mix)
Johnnydangerous - I Feel Life (Sinner & James Remix)
Alaya - Came to Chill (Original Mix)
Can't Get Enough! (Illyus & Barrientos Extended Club Refix) (Mixed)
Fhaken, N-Telekia, Alaan H - Mole (Original Mix)
Vangelis Kostoxenakis - Ubar (Extended mix)
Louden - The Gambler (Original Mix)
Solarc - Ghosts (Original Mix)
GruuvElement's - Enters (Original)
Jaceo - Harlem Gigolo (Original Mix)
Redo Desyo - Put Your Hands Up
Mr. Lekka - Need You (Original Mix)
Electronic Youth - Aladdin's Cave (Original Mix)
10.NightFunk - Music (Original Mix)(Tech House)
Sidney Charles - A Billion Miles
Reboot - Beautiful Parasite (Cesar Merveille Remix)
Jamie K, Luigi Rocca, Penny F - Blame
Michael Hooker - My House (Original Mix)
Mark Castley - Bouncin Hammers (DJ PP Remix)
Alain Ducroix & Daniele Quatrini - Everything (Extended Mix)
Jt Panda - Dirty Love (Original Mix)
Matthias Tanzmann, Sven Tasnadi - Daytona
Will Easton - Life Coach (Original Mix)
Dj Csemak - Switchback (Original Mix)
Jaap Ligthart, Alice Rose - I Know Change (Show-B Remix)
Yana Paisley - Dance All Night (Robiin Remix)
Dalfie - Can't Think Right Now
2 Sides Of Soul - Solid (Original mix)
Crazy Bass (Tech Mix)
Fabio Macor - A Denial (Original Mix)
Alexis Raphael - Spinach And Lamb (Original Mix)
Dave Mayer - The Way You Move (22 Weeks Remix)
Josh Butler Ft Lono Brazil - The Essence Of House (Metodi Hristov Remix) - Noir Music
DJ Wady - Rock To The Rhythm (Extended Mix)
Francisco Allendes - Poncho
Animal Trainer - Krambambuli (Original mix)
Ascended Masters - Tribal Piano (Original Mix)
Maximus Bellini - Headphones (Original)
Groove Masters - Dans
Everyday (Mathias Kaden`s Repitch Remix)
Mark Knight, Shovell - Selecao (Original Mix)
Luke Caspi - Jungle Club (Original Mix)
Nino Bua - Digital Freedom (Original Mix)
Delgado - Re Arrange Things (Original Mix)
Niceteed, Groove Killah - Wickedness (Original Mix)
James Meid - Live Speech (Original Mix)
Kaysin - Groove On Display (Original Mix)
Mecre - Acid 101 (Original Mix)
reDJesh - My Love (Original Mix)
Domscott - Bring on The Rain (The Deepshakerz Remix)
Felipe Brizzi - The Key
Housefanatics invites DiVine (30-5-2020)
Spega - Back To Back
The Deepshakerz - Can't Fear (Original Mix)
Dmitri Saidi, Sinner & James - Dis Poem (Original Mix)
DJ Remix Danila ft Gosia - Let The Music (Belocca Remix)
Federico Molinari - Limpia Madrid (Christian Burkhardt Remix Digital Bonus)
Dj Csemak - Underworld (Original Mix)
Maxinne, DJ Rae - Control
Kerri Chandler - Hallelujah (Mihalis Safras Remix)
Steve Lawler - Generation Acid (System2 Remix)
Stuart Ormerod - How I Go (Original Mix)
Daniel Steinberg - Paranoia Bar
Codes - Nah Mean (Original Mix)
Crosfader - Oyo (Original Mix)
Vampyr - Da Hood (Original Mix)
King & Johnston - I Can't Imagine (JR From Dallas 90's Beats)
Denis Ago - Yeh Ah (Extended Mix)
Dany Deep - Midway (Original Mix)
Groove Killah - Hot Riddim (Traxsource Exclusive Mix)
Dlc - Maritality (Original Mix)
Gerbert Vos - Pisang (Original Mix)
Kered, Stripclub Junkies - Molte Donne (Original Mix)
Luca Bisori - Infidelity (Original Mix)
Joeski - Freedom Now! (Original)
DJ Steaw - Feel
Louie Corrales - Your Name (Original Mix)
Elian Dust - Leave It All Behind
Danny Serrano - Revival (Original Mix)
Reboot - 57 Punch Man (Original Mix)
Collective Machine - Retrospective (Original Mix)
Sahib Muhammad - No Set Beat (Instrumental)
David Penn - A Different Story (Simon Doty Remix)
On Air (Neza & Muller Groove Remix)
Jay Robinson - Lopsided
Kevin McKay - Move Ya Body (Extended Mix)
DEMOU - Forever (Original Mix)
All My Life
Soul Divide - Can You Feel (Original Mix)
Nothing But Funk - San Francisco (Original Mix)
Beki M - My Dreams (Original Mix)
Supernova - Get Enough (Mixed)
Roberto Cuccovillo - Childish Voices (Original Mix)
Steve R, Pablo Leone - Sitting Bull (Original Mix)
Brian Cid & Glenn Morrison  - The Flute (Original Mix)
Josh Gregg, Wheats, Marck Jamz - Drum Machine (Original Mix)
Sergio Saffe - The Block (Original Mix)
Moloko - Sing It Back (KAYSEN Deep House Remix)
Juan Chousa - El Afrocubano (The Afro-Cuban)
Babalou - In the Jungle
Alex Raider - The Magician (The Sound Alchemyst Remix)
Marco Darko - Know You Better (Original Mix)
Vanilla Ace, AYAREZ - Tinder (Original Mix)
SL2 - DJs Take Control (Slipmatt & Sooney 2018 Extended Remix)
Lunoize - 8ball (Original Mix)
Stanny Abram - Black Jack (Original Mix)
Hugo Villanova - No Way to Go (Original Mix)
Xiasou - Defected (Marcel Fermier Remix)
Oxia  - Give A Feeling Olivier Giacomotto Remix MATERI H¥023
Apollo 84 - Soulsnatcher (Original Mix)
Laura Jones - Bright Lights (Cassy Remix)
Mikey V - Freaks
Mark Knight, Danny Howard - You Can Do It Baby (Original Mix)
Lupe Fuentes - 1000 Watts (Original Mix)
HTM 130 Sergio Saffe, Lucas Ferreyra - World TV
Tim Engelhardt - Under Armour
Moodtrax - Nightlife (Original Mix)
Moonbootica - On The Corner (Original Mix)
Alaia & Gallo, Piem - All the Things (Original Mix)
Subk0de - Flashes (Original Mix)
Shadow Child - Ooh Tune (Danny Howard Extended Mix)
22 Weeks - Drop Top (Extended Mix)
Matt Tolfrey - All About You (Charlie Banks Remix)
Emanuel Satie - Strobe Lights (Original Mix)
Ruben Mandolini, Laura - Sole (Feat. Laura) (Chus & Ceballos Remix)
Dosem - Projection
Habischman - Moan
Jonnyknox, Luis Pitti - Gamer
Level Groove - Digital Vocal (Original Mix)
Finnebassen - Rotundo (Original Mix)
Prysma - Flat Wind (Original Mix)
DiMO (BG) & DJ Dove - Get Close (Unreleased Dub)
Juany Bravo, Liza Adamenko - Reincarnation feat. Liza Adamenko (Juliet Sikora Remix)
Eats Everything - Honey (Torren Foot Extended Remix)
Piero Scratch - Around (Original Mix)
Justin Jay - Cash Money
Xenso - One shock (Original Mix)
Luis Pitti - Dirty Flow (Original Mix)
Thom Bold - Go Psycho (Extended Mix)
Byron Stingily - Flying High (Boys Noize 909 Rework)
Enzo Siffredi, Qubiko - Fragma (Original Mix)
Jesse Rose - Carnival (Original Mix)
S.P.C. - Collision
Kerri Chandler - Fortran (Argy 6.23 Mix)
Sander Dellariva - Escaping You (Original Mix)
DJ Dan, Gettoblaster - Platform 54 (Brokenears Extended Remix)
Alex Gómez - Calada (Sebastian Reza Remix)
Miss Kay Dee - Ghetto Boy (Original Mix)
Marisol Grajales - Buena (Original Mix)
Cosimo Mele - Religion
AMORHOUSE, TONIX - YOU TURN ME ON ( REMASTERED )
Camilo Do Santos - Bubba Mint (Original Mix)
Emanuel Satie - Cold Sweat
Make You Down (Original Mix)
Per Johann - Shake (Extended Mix)
Pa la Fiesta Mi Compa
Coyu - Aruba (Satoshi Tomiie 101 Remix)
Tiger Stripes - Flash Workout
2Lovers - It's Like That (Alternative Mix) A.Ushakov
Roland Eszterhay - Metro (Original Mix)
Someguy - Back Before (Original Mix)
Apollo 84 - World Is Yours (Vincenzo D'amico Remix)
Vini Sist - How Did You Know (Original Mix)
Rajiv Alfaroo, Mario Fx - Dingbat (Original Mix)
Joshwa (UK) - Do Your Thing (Original Mix)
Oscar Cano - Crazy
Marco Bruzzano
Oliver Dollar, Brillstein - Steeley Damn (Original Mix)
Jama (Berlin) - Heim (Original Mix)
David Keno - You High Yet (Original Mix)
Lord Huron - The Night We Met (Official Lyric Video)
Cloonee - Gospel (Original Mix)
Franky Rizardo - Troubleman
Dombresky - Trust The Process (Original Mix) [Insomniac Records]
Marshall Jefferson - Mushrooms (Wally Lopez Remix)
Ashnikko - STUPID Feat. Yung Baby Tate (Official Video)
Fond8 - Take That (Extended Mix)
Ralph C - About Last Friday Night (Original Mix)
Kaiser Souzai - Arp (Original Mix)
dj dew teknoo
Ya Know
Chris Rawles - That's What to Do (Original)
Klaus Blatter - Ball Bearing Factory (Elliot Adamson Vocal Mix)
YINGYANG (UK), Ren Phillips - Loco (Extended Mix)
Sidney Charles - Jack Endlessly (Original Mix)
Chris Hartwig - So Strong (Original Mix)
Adrian Oblanca, F.Gazza, Juan de la Higuera - Mister Galiano
Greck B - Miss Sousa (Original Mix)
Sinner & James - All About
Carlos Torre - Get Up Feat. Cee Vox (Original Mix)
Teddy Jiyane - Senti Drums (Sandy Rivera Remix)
Scream (Extended Mix) (Mixed)
Kauan Gouveia - All Be (Original Mix)
DJ PP - Groove You (Format B Remix)
Glen Coombs - Bring Back Soul (Original Mix)
Don't Let Go
Red Met - Shake It (Original Mix)
Los Suruba, Dennis Cruz, Celeda - Funk You
Stuuks - Thunder (Original Mix)
Simon Doty - Your House (Original Club Mix)
Daniel Steinberg - Bones
Folgatto - Intense (Original mix)
Traffic Beats - No Soul (Original Mix)
Lee Cabrera, Mike Vale - Shake It (Extended Mix)
Paolo Barbato - Just A Groove (Original Mix)
Delgado - Just Ride (Original Mix)
Paluma - Britney (Eli Bury Edit)
Triple888 - Groove (Sanchez Dirty 90's Mix)
Hollen - Trooper
Cele - In My House (Original Mix)
Sixteenth Pulse - Ba Slim Jim (C.Hornbostel Dub)
Red Met - Self Groove
Vangelis Kostoxenakis - Me Horny (Original Mix)
Danny Kolk - Boss Room (Original Mix)
FreedomB - Devil House (Original Mix)
Shroud Shifter - My Space (Original Mix)
Cloonee - Real Thing (Iglesias Remix)
Patrick Meeks - Its Time (Original Mix)
Caitto - Your Beat (Original Mix)
FOLEY (UK) - Twisted Disco (Preacher Mix)
Groendahl - Gimme A Sign (Extended Mix)
Nic Fanciulli, Andrea Oliva - Medium Rare (Extended Mix)
David Herrero - Don't A Rush (Original Mix)
JJ Mullor, Toni Carrillo - Yeah Boy (Original Mix)
Eagles & Butterflies - Birds of Paradise
Aphorism (Original Mix)
Angel Heredia, David Class - Oleo The Shark (Original Mix)
Dennis Cruz - El Sueño (feat Martina Camargo)
Illyus & Barrientos - Promise (Extended Mix)
Moreno Pezzolato & Philip Z - Say My Name (Original Mix)
Alessandro De Tuglie - Raw Inside
Barabar - Loops & Grooves A1 (Original)
Luigi Rocca - How Wow
Alex Kenji, Manuel De La Mare, Luigi Rocca - Colors Original Mix
Liquefied - Countries (Original Mix)
Gareth Harding - This Is Congastone (Original Mix)
Sidney Charles - Jack Endlessly
Jaceo - Desire
Dj Csemak - El Santos (Original Mix)
Andres Pesqueira - Step Up (Original Mix)
Alex Kenji - Right Now (Original Mix)
Sandor - L.O.V.E. (Original Mix)
Just Know (Original Mix)
Jewell Of London (David Kinnard Remix)
Cody - Smoking Weed (Original Mix)
Mihalis Safras - Barrage
G Flame - Turnmills
Booty Training Indian Meatballs Curried Rice Almond Baked Potato Three Ways Honey BBQ
Evolution (Extended Mix)
My Tech Beat (Original Mix)
Schmidt's Walk of Shame
BRADII - Generation (Original Mix)
Cristian Vinci - Tambor y Plena (Original Mix)
Plaster Hands - Gipsy (Original Mix)
KI Creighton - Energy (Extended Mix)
Klaus Blatter - Space Girl (Prins Thomas Mix)
Dany Cohiba - Wokaranda
Daniel Greenx - Try Twice (Original Mix) Neptuun City
Kristin Velvet - Rockin'
Go Freek - Luminosity (Extended Mix)
Secret Project - Nightcrawler (Original Mix)
Gorge - Tayo (Original)
Jamie Fielding - Mind 3 [Hottrax]
Mad Stadt - Glorya
Paolo Fanelli - Bend & Decay (Original Mix)
Dave Martinez - Callejera
David Herrero - Titeres (Original Mix)
Javi Lopez - 90s Wasted (Original Mix)
Morenno Martinez - Take Me With You - Loulou records (LLR219)
Joba - Oh Boy (Original Mix)
Stefano Kosa - Tigghy (Extended Mix)
Joaquin Koen - House & Love (Original Mix)
Drillisch - Be Mine (Original Mix)
Luthier - So Dramatic
Jess Bays - Every Little Thing - Stanny Abram remix
Upercent - Caos
All I Need (Re-Edit)
Fabio Salerni - Organic (Original Mix)
Dom Dolla - San Frandisco (Walker & Royce Extended Remix)
CASSIMM - Atliens (Hands Up Mix)
Prompt - Outbreak
Gogan - Juno (Original Mix)
Shakira - Loba (Video Oficial)
Martin Ikin, Chenai - You (Extended Dub Mix)
22 Weeks - Beyond Reach (Original Mix)
Roos, Mc Astro - Imagination (Frivolous Jackson Remix)
Cosmin Horatiu - On The Edge (Fernando Campo Remix)
Sovax - The Beat (Original Mix)
Tony To Van - Taal (Original Mix)
Mason Maynard, Eddie Cumana, Stuart Bridges, Eva - 13th Street, New York City (Original Mix)
Alessio Caforio - Its All About Me
Barbex - Love On
Paul Strive - No Satisfaction (Original Mix)
Chase Buch and Nick Olivetti - Get Runny (Soul Minority Remix) Night Drive Music
Matt Mclarrie - Hood Lessons
Friends Cortese - No Hashtag (Original Mix)
Riva Starr - The Wickedest Sound (Snatch! Mix)
Pele, Shawnecy - Better For My Brain (Original Mix)
Francisco Allendes - Superwave Theory
Paolo Martini - Bad Pitch (Original Mix)
Andrea Giudice, Larry Cadge - Baby (Mark Knight Extended Rework)
Cowlin - Listen Up (Original Mix)
Tolstoi, JJ Mullor - Gettin' High (Original Mix)
DMS12 - Eno Minimal (Original Mix)
Odyffe - Play With Me (Original Mix)
Sllash & Doppe - Party With Somebody (Original Mix)
Danny O - Tapes & Stuff (Original Mix)
Ellis Moss - The Shake (Extended Mix)
birdhouse - OMG
James Silk - Escape (Original Mix)
Makanan - Strobe Lights (Original Mix)
Neculai - Put It On (Original Mix)
Sound Stealers - Exoesqueleto
Antonio Valente - Mandrake (Gel Abril Mix)
Luca Lento - Strip Out (Original Mix)
Karsten Sollors - Hold Lock
This Culture - Vibrations (Extended Mix)
Sebb - Empire
How We Do (Felipe Fella Extended Remix)
Luke Marsh - Project X (Original Mix)
Italo Perez - Must Be Love (Original Mix)
AndThen - Feisty Latina (Original Mix)
Paolo Martini - I'll Take You There (Original Mix)
Artist TBA - Shoop Loop
Apollo 84 & Atove - Cope (Original Mix)
Shaen - One Of A Kind (Original Mix)
Undercolors - Distance of Me
Sergio Del Lago - The Cry of Hope
Paco Wegmann, Javi Bora, Hector Moralez - Back To Paris
Groove Armada - Superstylin' (Riva Starr Edit)
Richi Risco - Fame (Original Mix) [OBSERVATORY MUSIC]
Fragment The Cook
Yenk - Original Wild Style (Original Mix)
Rick Silva - Deep Inside Acid (Original Mix)
Riva Starr - The Wickedest Sound (Original Mix)
Skapes - Drop the Needle
Erick Morillo, Junolarc, Ora Solar - Blinded (Extended Mix)
Red Weeller - Awake
Chus & Ceballos - Kokoro
Neeco - Chipper
Digable Funk - H2O (Original Mix)
Sovax - Girlz (Original Mix)
Ressless - Indigo (Original Mix)
SP1DER - House Calling 2015 (Original Mix)
Holt 88 - Brack Down (Original Mix) [DIRTYBIRD]
Beki M - Do It (Original Mix)
JULENN - Aux Fraises (Original)
Pleasant Avenue - Just One (Original Mix)
Basement Jaxx - Good Luck feat. Lisa Kekaula (Butch Remix)
NerveStrain - Happiness (Original Mix)
FISHER - Freaks (Audio)
Sidney Charles - Psyjack
Anja Schneider - Twisty
Under_Score - Lucky Day (Original Mix)
Hacer
Corre Morenita (Extended)
Winx - Don't Laugh (David Morales Red Zone Mix)
Ollie Viero - La Hoya (Original Mix)
Rafa Barrios - Sense (Extended Mix)
Leikeez - Alarm
Javi Lopez - Proper Side
DirrtyDishes - You (Original Mix)
Rocketpunk - At Cooking
Davide Mazzilli - Te Quiero (Original Mix)
Gabriel Carrillo - Get Back (Original MIx)
Ismael Casimiro - Fast Movement (Original Mix)
Raffa FL - I'll House You
Carl Bee - Got Me Thing (Original Mix)
Bastian Kay - This is The Way (The Sahoo Conection Remix)
No Artificial Colours - Werk (Original Mix)
Mark Knight, Mr. V - We Get High From The Music (Original Mix)
Jon Flores - Bugaboo
Martin Ikin, Hayley May - Following (Original Mix)
Jerome Baker - Minion
Piem - Your Mind (Original Mix)
Route 66 - Revolution (Tough Love Remix)
Dumi - 2 Days (Original Mix) [Dum A Dum Records]
Hauswerks - Workin' On (Original Mix)
Kevin McKay, Joshwa (UK) - Such a Good Feeling (Extended Mix)
Nico Cabeza - Time Warp (Original Mix)
Beller - Rock This Groove
Olly Davis - Get Down (Original Mix)
Norty Cotto - Alacran (Club Mix)
Arche - Beats Please
Carlos Roll - Trio de Ases (Feat. Toni Maravillas) (Original)
Beki M - World Up Radio Show #114
Gordon John - Brainwashed (Original Mix)
Marcos Arreza - Rotwave
Emanuel Satie - Paffo's Riff
Andre Rizo & Kataa - Let It Move
Xiaomi - Nuevo Mi 10T Pro
Dario D'Attis - Disco Ducks (Original Mix)
Emery Warman - Don't Stop the Music
Gene Farris - Soul Food (Extended Mix)
Riva Starr - Body Movin'
Joeski - I Rise
Wrighty - Give Me the Beat (Original Mix)
Koen Groeneveld - Aha Yeah! (Original Mix)
Ryan Wallace - Feel That Rhythm (Original Mix)
Jack Back, CeCe Rogers - Freedom (Harry Romero Extended Remix)
Illyus & Barrientos - Shout (Original Mix)
Alessandro De Tuglie - Got U Baby (Original Mix)
Dilby - Don't Leave Me (Original Mix)
Sllash & Doppe - Predator (Original Mix)
LucaJLove, Checco Saponaro - Pusher (Original Mix)
You Got Me Working (Extended Mix)
B-liv - Murga pa' Allá
Klangkuenstler - Jazzy Jam (Original Mix)
Made By Pete - Drunk In Chicago (Original Mix)
Alex Twitchy - U Rock Tonight (CASSIMM Remix)
Sonickraft - Keep on Getting Better (Original Mix)
MoreCause - Trombona (Original Mix)
Lupe Fuentes - Let It Feel Alright (Javi Lopez Remix)
Sauvage back - Do What You Want (Epic Mix)
Carlo Marani - Intro (Original Mix)
Gangsters (Ariano Kinà & Marco Bruzzano Remix)
Leo Pablo - Rat Pack
Ekoboy - Ever
Tom Bug - Burn The Motha (Original Mix)
TLC - Creep (Remixed By Lauren Lane)
Rau.du - Control (Original Mix)
Jaimy - Shake Your Body (Herck Remix)
Audio kode - #StreetPose (Original Mix)
Steve Lawler - 12 Bottles (Original Mix)
Modegroove - Margarita (Original Mix)
Joeski - Same Revolution (Original Mix)
Roberto Palmero - Be Chain
Sidney Charles - The Pump (Original Mix)
Gemini 529 - Party Rockin' (Original Mix)
Trauma - Higher (Josh Butler Remix)
Walkin'Talkz - Money honey (Original Mix)
B-liv - Khumbu (Original Mix)
Jacob Colon - Love Lockdown (Original Mix)
Tini Garcia - Absent (Original Mix)
Stephen Nicholls - The Finest (Denney Extended Remix)
DJ Nanni - I Wanna (Original Mix)
Sugar Babe (LuN Remix)
SMOKI - Rush (Original Mix)
Redondo - Your Underground (Original Mix)
Juanito - Trunk Line (Original Mix)
Tobias - Fiya Bun (Original Mix)
Niko Valt - I Feel It
Jean Bacarreza - Rooftop Afterparty (Original Mix)
Fake Blood - Hornets (Original Mix)
Stanny Abram - Automatique (Original Mix)
Ronnie Spiteri - Spiral (Original Mix)
Tamborder - Carmelita (Original Mix)
Prickly Pear
Dusky - Square Miso
Metodi Hristov - Grab For Ya (Original Mix)
Joe Berm - Project Berm (Original Mix)
Richy Ahmed - Jammin'
Vangelis Kostoxenakis - I Dont Give A... (Original Mix)
Lupe Fuentes - The Drugs (Original Mix)
Ronnie Spiteri - Acid Lights (Original Mix)
Funk V. - Anna (Original Mix)
Javi Colors - Old School (Original Mix)
Enzo Sorrentino - Colli Gioiosi
Mr. Lekka - Automatic (Original Mix)
Ekoboy - Hard to Resist
Static Revenger - Happy People (Erick Morillo Extended Remix)
James Meid - Around Me
Onno - Off The Grid (Okain Remix)
Andrew Mina - Put Your Hands Up (Original Mix)
Kuestenklatsch - If You Believe (Original Mix)
Marshall Jefferson & Solardo - Move Your Body (Extended Mix)
Vito Pignatelli - Reverside (Original Mix)
Trutopia - In My Body (Original Mix)
Oscar L - Nature
Tiger Stripes - Back To Detroit City
Joeski - Tribute to Obatalá
Grumble (Jey Kurmis Remix)
Nick Hollyster - Balance (Original Mix)
Kolombo - Retro Drop
Martin Ikin - Good Feelings
DJ Simi - Negative (Gianni Romano & Emanuele Esposito Remix)
Kiran - ChoKolate Soda (Cristian Marin Mix)
Bruno Furlan - Shantytown (The Deepshakerz Vocal Edit)
Piemont - To The Point (Original Mix)
Todd Terry & House of Gypsies - Samba 2017 (InHouse Mix)
Jon Flores - Vintage
Paolo Barbato - The Music
Kaiserdisco - Kuala
Groovekode - Masia (Original Mix)
I Feel That Love (Original Mix)
Miki Leris - Test My Lemonade (Peter Makto & Gregory S Remix)
Nearly! 70 Kilograms of Gold Nugget; Huge Actually
Papa Marlin - So Long
Franky Rizardo - Punta del Este (Original Mix)
Ramble Rebel
Paranino - The Promise (Vangelis Kostoxenakis Remix)
Papa Marlin - So Long (Original Mix)
Illyus & Barrientos, Max Marshall - Chase Your Trip Feat. Max Marshall (Underground Dub)
2 Sides Of Soul - Say Mama (Original Mix)
Jude & Frank - French Fries (Original Mix)
Reblok - Keep Me High
Riva Starr, Dennis Cruz, Gene Farris - Play (Original Mix)
Mowgli - La Lokomotiva (&Me Remix)
Simon Adams - 1974
Belocca - Good Love
Ky William - Baby (Original Mix)
Marc Ross - Dare
Lorenzo Bartoletti - Solid Cluster (Original Mix)
Abolengo Club - Party People (Original Mix)
ANOTR - Uni (Original Mix)
Matt Star - Baboo
Lessovsky - Placebo (Original Mix)
Freejak - All I Wanna Do (Original Mix)
Nic Joseph - Obsession (Original Mix)
James Meid - Djs Bag
Renaud Genton - Get Up On Ya Feet (Original Mix)
German Brigante - Noose (Original Mix)
Moonwalk - Walk Alone (Original Mix)
Ann Nesby - So Much Joy (Lorenzo Spano Extended Remix)
Markomas - Ninety Three (Original Mix)
Martin Ikin - Hooked (Extended) [Catch & Release]
Ronnie Spiteri - All Wrapped Up (Original Mix)
Shiino - Doing What You Said (Original Mix)
Ninetoes - Quarantine Love
Kadenza - Front 2 Back (Original Mix)
Collin Priest, LucaJLove - You Want It (Original Mix)
Salento (Radio Edit)
Joshwa (UK) - You're Not Alone (Moreno Pezzolato Extended Remix)
Hallelujah (Dub Mix)
Marc Ross - Reflex (Original Mix)
Oliver Schmitz, Micah Sherman - Cold Turkey (Original Mix)
PashaRed - D.A.P.P. (ACAB Mix)
Majesty - Turn Up The Bass (Original Mix)
Chevalier - Double Dealin'
Lexa Hill - Go Down (Original Mix)
Ashibah - Devotion (Extended Mix)
option4, Treasure Fingers - Bar 97 (Original Mix)
Modd - Maru
Davide Mazzilli - Very Well (Original Mix)
DJ Dove - Back At It Again (DiMO BG Remix)
Ruben Zurita - I'm Alive (D-Trax Remix)
Dolly Rockers - Shake (Original Mix)
Tina Says - Elevate
Mirko Di Florio - Revolution
DJ Hightech - Reverie (Original Mix)
Sonny Wharton - Those Were The (Rave) Days (Original Mix)
Deftone - Balkan Swordfish (Original Mix)
Lucas Ferreyra - Big Deal
Sllash & Doppe - GO OFF (Original Mix) [NONSTOP]
Ryky - Underground Perspective (Original Mix)
Klangkuenstler - It's the Inside
The Rudeman - Attack Pattern (Original)
Dirty Dan - Thru The Club
Will Monotone - Pound Road (Original Mix)
Savi Leon - Find Mine
Phoenix Movement - Reborn
Wolf Jay - Don't Leave Me (Original Mix)
Francisco Allendes, Aldo Cadiz - Esa Nena Quiere (Dennis Cruz Remix)
DJ Lora - Brazilian Track (Original Mix)
KPD - Extasy (Sinner & James Remix)
Sem Thomasson, Sinner & James - Final Call (Sinner & James Extended Remix)
AngelLopez - LXXXIV (Original Mix)
Ecko2 - Ademán (Original Mix)
Damon Hess - Dirty Happy People (Original Mix)
Loving & Surrounding (Original Mix)
Alonso Bierg - Subsuelo
Lexlay - Never Deser Me [Beatfreak Limited]
PEZNT - Cashke (Original Mix)
Alex Sellens - Badass (Original Mix)
CASSIMM - Shined on Me (Extended Club Mix)
Frankie Watch - Last Weekend
Dempsey Massy - AH (Original mix) [Nite Grooves]
Yvette Lindquist, Ida Flo, Carmen Gonzalez - You (CASSIMM Remix)
ItaloBros - Kate (Original Mix)
Jay Lumen - Night Glasses (Original Mix)
Arkay - Lovin Your Sound (Jaceo Remix)
Landmark - Right Choice (Original Mix)
Westend - Friend Zone - Country Club Disco
Sllash & Doppe - Clothes Off (Original Mix)
Mariano Salazar - La Fiesta (Original Mix)
Mitch de Klein - Cancun (Original Mix)
Dani Holl - Old Side (Original)
DJ Jeroenski - Ayaa (Original Mix)
Sebastian Ianno - Red Code
Aleeg - Black Air
Matt Fear - Disturbing The Peace
The New Sins - Lights Down (Franky Rizardo Remix)
Crimsen - Acid House
Freaks - He's Angry (Honey Dijon Remix)
Mike Vale - Music Is The Answer
The Golden Boy - 8 Bit (Original Mix)
Javi Lopez - Rock The Beat (Angel Pina Remix)
Coqui Selection - Take This Out (Jorge Montia Remix)
Ruede Hagelstein - Soul Dynamic (Douglas Greed Remix)
Five (Original Mix)
K-Mack - Devotion (feat. Ellie Sax) (Original Mix)
Angelo Ferreri - Everybody Fucking Dancing (Living In The World Original Mix)
Codes - Go Down
Mike Konstanty - Crazy Shaman (Original Mix)
Rankay - Can You See The Lights (Kuestenklatsch Remix)
Ricardo Motta - The Drum (Original Mix)
Piero Scratch - Realize
Michael Bibi - Devil's Candy (Original Mix) SGR016
Lotrax - Beat Boi (Club Mix)
Tube & Berger - Envy (Pirupa Remix)
Shiba San - Let's Go Dancing
Harry Romero - Deep Down (Extended Mix)
Dennis Cruz - Shake It Out (Original Mix)
Chopped That Sucker in 20 (Original Mix)
Hannah Wants - Girls & Boys (Original Mix)
Lexa Hill - A Mi Manera
Defected In The House Radio 29.02.16 Guest Mix Friend Within
Might Kingdom
Ordonez - Pornographic Creatures (Original Mix)
Christian Hornbostel - Paradigma (Original Mix)
Angel Anx - Save Me
Josh Butler - The System
Dario D'Attis, Kinnerman - Won't Stop (Extended Mix)
Jeremy Juno, Daniel Beasley - Drum 'N Coke (Original Mix)
Solardo - The Aztecs (Original Mix)
David Penn, Kevin McKay - Hallelujah (Joshwa Remix)
SecondCity - Say It (Original Mix)
Albert Marzinotto - You're Gonna Get Hit (Original Mix)
Mak Steven - Crumble
Hugo Rizzo - Namibe (Original Mix)
Krywald & Farrer - La Tolita (Original Mix)
Burnski - Circuits (Original Mix)
Solardo - The Step Off (Original Mix)
Davide Mazzilli - Disco (Club Mix)
JJ Mullor - Kimera (Original Mic)
WeMart - Dancing Rayo (Original Mix)
Andre Salmon, Xavier Freile - Mom It Hurts (Original Mix)
Sted-E & Hybrid Heights, Norty Cotto, Raul Soto - Mamajuana Feat. Raul Soto (Original Mix)
Milkwish - Mega Chord (Original Mix)
Matthias Tanzmann - Crazy Circus (Paco Osuna Remix)
Joss Moog - No Way (Original Mix)
Andruss, Jean Bacarreza - Wanna Hum Hum (Original Mix)
DJ Simi & Last Vision - Lithic Phase
Gianluca Calabrese - Just For Me (Original mix)
Wheats - 6AM
MU007 Paul Adam - Let It Go    (Club Mix) [Deep House]
Soul Bass - Cuba (Original Mix)
Piero  Pirupa - Fire (Original Mix)
Riccardo Barbaro - No Baby (Original Mix)
Sr. Funkie - For You (Original Mix)
Wladimir Tegarid - Just Don't Preach Me (Original Mix)
Oxia - Reset
Latmun - Utopia (Original Mix)
Elomak - Mocha Blanc
Juan Entrena - 87's Roll
Andy Reynolds - Glide 2.0
Narda - SSS (Original Mix)
Warrior (Original Mix)
David Herrero - The Chicken Attack (Original Mix)
David Herrero - Aromas
Fond8 - Warning (Extended Mix)
DirtySwing - Afterhouse (original mix)
Superstitious (Original Mix)
Luuk van Dijk - P.O.W (Extended Mix)
Jon Flores - Dirtyhappy People (Original Mix)
D-Nox - New Life (Original Mix)
Brett Gould - Origins
Max Esposito - Hela Hey (Original Mix)
Dj Fabrizia - Doing My Thing
Zoo Brazil - Moments
Fickry - Just Beat (Original Mix)
Fabbie - Glow (Original Mix)
Soul Divide - Dark Dreams (Original)
Jay Shepheard - Bullfrogging (Original Mix)
Iglesias - Dubler
Federico Weish - Mother (Qubiko Remix)
Kerri Chandler - Bar A Thym (The Deepshakerz 2014 Rework)
Camilo Do Santos - 1992 (Original Mix)
Jey Kurmis, Nukov, Yelmet - Not Too Flabbeh (Original Mix)
Gorgon City - Blame ft. Josh Barry (Terrace Dub)
Ramon Tapia - Karma
Norman Zube - Mahori (Original)
Dave + Sam, LATASHÁ - You Da Shit Girl (Harry Romero Extended Remix)
Junior Sanchez - Live 4 Da Funk (Vangelis Kostoxenakis Extended Remix)
Harry Romero - Poema (Extended Mix)
Paji - Opus 7 (Original Mix)
Wilian Kraupp, Kaiq - Volcano (Original Mix)
Davide Neri - Tartaro
Dosem - Replicants (Original Mix)
Stanny Abram - Wanted (Original Mix)
Daniel Rateuke - Need Some (Original Mix)
Nausikke - Oh Wah (Original Mix)
Dennis Quin - Drive (Extended Mix)
Mindek - Kegals (Original Mix)
Simone Liberali - Watch Out (Original Mix)
Dubesque - New York Jack (Original Mix)
Juliet Sikora - Beat Dancer (Original Mix)
Twins Up - Fuzzy
Gordon John - Listen Up (Original Mix)
DJManuel - The Underground
Sha-Lor - I'm In Love (Electronic Youth Remix)
florian gasperini - sunday 2pm ( sci+tec )
Angelo Scalici - Make The Floor Shake (Original Mix)
Joey Avila - The Hype Is Real
Nino Bua - Once Again (Original Mix)
Deep Criminal - Just Play (Original Mix)
PaperMacheTiger - Satisfaction (Original Mix)
Timmy Trumpet & Savage - Freaks (Official Video)
Marco Lys - Kama (Original)
Felipe Kaval - Imagine (Original Mix)
Kassandra (Original Mix)
Licata & Linares - Inbound Route
Nina Kraviz - Okain's Scream (Sebo K Mix)
AFM Groove - Bluee
Illyus & Barrientos 'Takin' Over'
Dj Csemak - Nasty Boy (Original Mix)
Los Pastores - What Swat
Rokaman - Krispy Kranz (Original Mix)
Softpaw - Don't Worry (Original Mix)
Out_Ctrl & Dub Forge - Time To Attack (Original Mix) [KOFFE RECORDS]
Maceo Plex - Conjure Drama (Original Mix)
Philip Bader - Tec Talk
Glenn Morrison - Tough Love (Original Mix)
Frankie Deep - Prismat Elements
Paul Kaloko - Surreal (Original Mix)
Javi Lopez - Call Me Poison
Sante Sansone - Warehouse
Tassio - Numas (Original Mix)
Francisco Allendes, DJ DMC - Agility Queen feat. DJ Dmc
Eddie Thoneick, Kurd Maverick - Chicago (Extended Mix)
Dennis Beutler - Phat Body (Original Mix)
Riddimjunkies - Listen
Collin Priest - Abstract (Original Mix)
CASSIMM - Body (Original Mix)
Jamie Trench - Let Me See You Work
Okabi - The Macaw's Moustache (Original Mix)
Raul Facio - Money
All I Need
CASSIMM - What Ya Doing (Original Mix)
SamBRNS - Baila
Sandy Turnbull - Tell Me
Kuestenklatsch - Headphones (Original Mix)
Joseph Mancino - In My Head (Original Mix)
Francisco Allendes, Pablo Inzunza - Caligula (Original Mix)
Massimo Lippoli - Let It Ride (Dario D'attis Remix)
Branco Simonetti - Everybody Dont Stop
Save Me (The Ger-Man Edit)
Moshem - Honey (Extended Mix)
Oliver Thomas - Nasty Juice (Original Mix)
Marco C. - Pump Up (Original Mix)
DJ Oliver - Turia
ATFC - Shots From The Hip Vol 5 (Bring The Beat Back)
Innerbloom (H.O.S.H Remix) (Mixed)
DJ Wady - Power Man (Original Mix)
Power Man (Original Mix)
Simone Tavazzi - Run
DJ Wady - Pumping (Original Mix)
Sven Tasnadi - It's Your Love
Pazkal - This Tune (Original Mix)
Taty Munoz - Encoder
Sidney Charles - Whiplash
C.O.T. - Let It Go (Mark Knight Extended Edit)
Di Chiara Brothers - Tobacco (Original Mix)
Brett Gould, Shyam P - Can't Hold Back (Original Mix)
Wheats - Dedication (Original Mix)
Upercent - Spaceman (Original Mix)
Franky Rizardo - Tempo - Original Mix
Crusy, KPD - Wrong Time (Original Mix)
Aj Montes - Dispersion (Original Mix)
EdiP - Manijas
Farshad Kay - Suicidal Rabbit
Arco - Dark Warrior (Original Mix)
Susy Seven - Sometimes (Original)
Room 202 - Ghana (Ant Brooks Mix)
Merimell - Cyber Seduction
Kadenza - Bambalaya (Original Mix)
Sweet Peace
Luciano Pardini - White Pill (Original Mix)
Sergio Bennett - Brazilian Dynamite (Extended Mix)
Yamil, Joe Red - Bus53 (Original Mix)
Ryan Padley - All Around Me (Zeljka Kasikovic & Aleksandar Savkovic Remix)
Lissat & Voltaxx - Carpenter (Original Mix)
Hiast - Wanna Feel (Original Mix)
Martin Ikin - Back In Time - Extended Mix
Dead Space - Come Early Dance Longer (Original Mix)
Flaviano Lanzi, Simona B. - Noche de Eivissa (Original Mix)
Hansol - Dislove (Original Mix)
Paul Lock - MotherThugger (Original Mix)
Jhonsson - Catch Me
Mutiny Uk - Addictionz (Extended Mix)
The Scumfrog - Spin (Simone Vitullo Remix)
Sllash & Doppe - Bamboo Straw (Original Mix)
Mirco Caruso - Just You & Me (CAAL Remix)
Chus & Ceballos, Dennis Cruz, DJ Chus, Pablo Ceballos - The Sun (Matthias Tanzmann Remix)
Sooney - Kandi Flip (Original Mix)
Mat.Joe - World In Action (Original Mix)
Silkeepers - Looking To My P (Extended Mix)
Rich Wakley - In The Place (Alvaro Smart Remix)
Da R3volution - Gimme More (Dany Cohiba Remix) [House]
Something New (Jey Kurmis Remix)
Harry Romero - Revolt (Extended Mix)
Qubiko, Fabio Ricciuti - Monky Fonky (Original Mix)
Prune Flat - Adrenalyn
Tania Vulcano, Jose De Divina, AudioHell - Barlume
Hybrid Theory, Martin Green - Habit (Original Mix)
Feel so Good (Extended Mix)
Tom Bug & Grooveline - Just Wanna (Original Mix)
Vinyl Hutz - The Drum Machine (Original Mix)
Mhod - She Moved to Mars (Original Mix)
CASSIMM - S.T.O.P (Original Mix)
COMR100 20 D'a Rosa - Baila (original mix)
Antonio Thagma - Leather Soul (Original Mix)
N.I.M - Zaghrouta (Ces Castro Remix)
Seff - Reach (Original Mix)
Jojo Angel - Burning Up (Original Mix)
Stanny Abram - Violet Room (Original Mix)
South Royston - Do It Like That (Original Mix)
Marco Faraone - Night in Lima
Marcus Zuercher - Stimulation (Scott McCool Remix)
Made By Pete - Jungle Funk
Veev - Custard Fat
DJ Dove - Touch My Soul (Extended Mix)
Return of The Jaded - Works (Original Mix)
Deeper Than L - Thanos (Extended Mix)
DJ Wady - Pata Negra (Original MIx)
Mark Zowie - Forever (In Ibiza) (Original)
Vangelis Kostoxenakis - Diss It (Original Mix)
RAMA7 - Smiling Faces (Original Mix)
Milk & Sugar - Ready Or Not (René Amesz Radio Version)
Jelly For The Babies  - In Front Of Me (5prite Remix)
Dany Deep - District Beat (Original Mix)
Matteo Rosolare - Back In Town (Original Mix)
Sansixto and Dgrace - Khasaia [Official Music Video]
Askin Dedeoglu - Guapa (Stress) (Original Mix)
Beta Function - Turning Point
Mendeler - Grange (Original Mix)
Alan Nieves - Butterfly (Original Mix)
Harry Romero - Rapture
Juanito - Make A Move (Extended Mix)
Julie Marghilano - Filled With Something (Subb-an Remix)
Mr. Kavalicious - Baller (Original Mix)
DJ Linus - Tellur
Darius Syrossian - Mischief Brew (Original Mix)
youANDme, The Analog Roland Orchestra, Black Soda - Reflection (Original Mix)
Kike Henriquez - Alchemy (Original Mix)
Kill Frenzy - Silo (Original Mix)
Jo Crimaldi - Wakanda (Original Mix)
Adoo - One Groove (Original Mix)
Paolo Solo - B or B
Raffa FL, Di Chiara Brothers - All About That Bass
Loco Dice - 2Thousand3 (Original Mix)
Dj Csemak - Change (Original Mix)
Metodi Hristov - Speed (Original Mix)
Codes - Club Meditation
Around the Bane (Noir Mashup Treatment)
Beki M - I Feel That Love
Mineo - Turn Out The Lights (Jamie Jones Remix)
KODEWERK - Body Movement (Original Mix)
AYAREZ - Turn Around (Original Mix)
Di Chiara Brothers - Our Mind (Original Mix)
O-Galla - Feel The Music (Extended Mix)
Ms.Fuji - The Code (Original Mix)
Joy Marquez - Early Dimension (Original Mix)
Oscar Cano - Koriki
Skapes - Interconnect (Original Mix)
Nausikke - Rock That Run (Original Mix)
SYAP - Moving On (Original Mix)
Italoboyz - Junior Junior
Fedde le Grand, Funkerman & Dany P-Jazz - New Life (Bingo Players Remix)
Armand Pena - Real Talk (Dirty)
Dee Montero - Infinity (Extended Mix)
The Big Brother - Route 303 (Original Mix)
Tuff London - Strobe ( Extended Mix )
Alexic Rod - Ah Ah Ahhh (Original Mix)
BRADII - Get The Funk (Original Mix)
Franky Rizardo - Tempo (Original Mix)
Huxley & Jacky - Rave Dance (Original Mix)
Ruben Mandolini - Abduction (Original Mix)
Sllash & Doppe - Duplex (Original Mix)
Enzo Siffredi - Sometimes (Original Mix)
Enzo Siffredi x Be Like Butter - A-Side [Strictly Rhythm]
Hot Lipps Inc. - Blouse & Skirts (Detlef Remix)
Dany Cohiba - Come Back (Original Mix)
CASSIMM - The Music (Original Mix)
Mirco Caruso - Again & Again (The Deepshakerz Rework)
Gunther Beats - Gang Alert (NicoRozas Remix)
Wehbba - Turning Point
Ruben Mandolini, Catsinka - No Diggity (Extended Mix)
Pelvis Moves - Pray (Extended Mix)
Ninetoes - Paapaa
Ivan Iacobucci - Router
Sebo K - I Feel It
Rub A Dub - Malfunked Substance 005
Antonio Manero Spaziani - Ashanti (Original Mix)
GW Harrison - Hear My Soul (Extended Mix)
Roberto Palmero - Less Is More
Rob Nutek - Funderground (Original mix)
Piero Pirupa - Our Sound (Original Mix)
Luigi Castaldo - Inside Me
E-Funk, Donica Thorton - Feel It And Shout (Pirupa Extended Remix)
Steve Kennedy - Bullshit (Original Mix)
Sllash & Doppe - UFO (Original Mix)
Killed Kassette, Tuff Dub - Record Spins
Ray MD - Old School In Tha House (Original Mix)
Pazkal - Please
Man Without A Clue - Hello (Original Mix)
Jorge Montia - The Preacher (Muzikfabrik Remix)
Dubman F. - Xtremely Deep
Matt Sassari - Your Body (Extended Mix)
Emeskay - Deleted (Original Mix)
Electronic Youth - Believe (Original Mix)
Funkwerkstatt - Melodien Für Millionen (Anthik & Felipe Puertes Remix)
Killed Kassette - Cooking It Up (Original Mix)
Lewis Boardman - Werk It
Detlef - Pump Up (Original Mix)
Stanny Abram - Kilima-Njaro (Original Mix)
Sebastian Darez - Enigma (Original Mix)
Kenny Ground - The Beat is Rockin (Original Mix)
Archie Hamilton - Driven To Distraction (Original Mix)
Javi Lopez - Hook You Up (Original Mix)
Dennis Quin, Edwin Oosterwal - Apollo (Original Mix)
Mark Knight, Green Velvet, Rene Amesz - Live Stream (Original Mix)
Davide Mazzilli - Dont Stop (Flavio Martini Remix)
Benny Royal - Muskito (Dirty Secretz Remix)
Jojo Angel - Ougourgou (Original Mix)
Brian Matrix - Break It (Original Mix)
Joseph V - Very Stella Mia (Original Mix)
Tough Love - What You Want (Extended Mix)
Brett Gould, Rion S - Lay Your Hands (Extended Mix)
Nicole Moudaber & Eats Everything - Big Dipper
Dany Cohiba - There Is No One (Original Mix)
Ekai - What's The Power (Extended Mix)
Hot Since 82 - Like You (Audiojack Ruff Cut)
Martin Ikin - Back In Time (Extended Mix)
Koel Wilder - Ligths On
Kaaiman - The Call
The Tribe Of Good - Loving You Baby (Weiss Remix)
Reeveze - Rumble (Original Mix)
Conga Squad - Tech Vibes (Original Mix)
PEZNT - In Your Face (Original)
Arno Stolz - Blacked (Original Mix)
Diabolic (feat. Cari Golden) (Douglas Greed Remix)
Gabriele D'andrea - Balearic Vibes (Original Mix)
Andrew Meller - Strings (Original Mix)
Bernardo Neck - Take (Original Mix)
Mat.Theo - Eskko (Original Mix)
Catz 'N Dogz - Gotta Know
Rick Silva -The Consequence(Original Mix)
Jason Young - Check It Out (Original Mix)
84Bit - Gici (Extended Mix)
Sander Dellariva - Groove Machine (Original Mix)
Morenno - Class (Original Mix)
James Meid - The Way (Original Mix)
Edward Wagner - The Fear
Andy Caldwell - Fear the Beard (String Mix)
Rob Nutek - The Sky People (Original Mix)
Mitch Major - Sweat (Original Mix)
Tapesh, Kevin Over - Secret Handshake
Apexape - Tribal Gospel (Extended Mix)
[Kling Klong] Redondo & Sideburn - Slicer
Chedey Garcia - Upside World (Original Mix)
Roland M. Dill - Broadband (Harvey Mckay Remix)
Uriel Leyva - Back To Myself (Original Mix)
Super Flu - Do Ex
Strandkvist - Feel Da Bass (Original Mix)
Stoned Entertainment - Me Encanta Tu Sonrisa (Stanny Abram Remix)
Dubdisko - Dirty Guetto (Original Mix)
James Meid - See Yah (Original Mix)
Botnek - Spaceman (House Divided Remix)
Alan Nieves - They Mad
Matt McLarrie - Tickly Voodoo (Joeski Remix)
Pavel Petrov - Break The Rules
Proper Villains - P.O.F.
Klangkuenstler - Block Party (Original Mix)
Space Food - Good Feeling (Original Mix)
ACAY - Warehouse Craze (Original Mix)
Phil Weeks - It's the Inside That Counts (Eats Reebeef)
Simon Mattson - Thug Life (Original Mix)
Simone Vitullo - Big Bang Troubles
Dev Bhandari - Truth (Original Mix)
Simon TG - Boom Boom (Original Mix)
Stanny Abram - Benirras (Original Mix)
Mihalis Safras - Lab (Original Mix)
Nader - By Day (Mihai Popoviciu Remix)
Bass Kleph - Back to Funk (Rober Gaez Remix)
Brett Gould, Shyam P - Believe (Original Mix)
Goom Gum - Hambone
David Ponziano - Ancestral Recall (Original Mix)
Saytek - Rhythms in My Head (Audio Junkies Mix)
Mike Vale - Music Is the Answer (Original Mix)
Vanucci - Bounce With It (Original Mix)
Okain - Coma
Penzo - Treat Me Bad (Original Mix)
Dj Asney - Madrid
Lizzie Curious - Music Is (Original Mix)
Kickbugs - All I Need
Pablo del Monte - Dem Toms Yo (Original Mix)
Emanuel Satie - Sound The Alarm (Original Mix)
Drop 2 Jump - Made To Summer (Original Mix)
Marco Lys - Go
The Deepshakerz - Moving (Analog Mix)
Clarity - Everyone Is Satisfied (Edit)
DONT BLINK - Come On Up (Original Mix)
Piero Scratch - Base Life (Original Mix)
Herr Arter - Palento (Kevin G Remix)
Louie Anderson - Dig Dis (Original Mix)
Juany Bravo - Loco (Mirko Di Florio Remix)
Mendo & Yvan Genkins - Hey Boy (Original Mix)
Carlo Medel - Medio Loco (Original Mix)
NHB - Get Up - Original Mix
Hysteria (Original Mix)
Stanny Abram - XTC (Dub Mix)
Harry Romero - Sing To Me Nina (Original Mix)
Lexa Hill - Hedonism (Original Mix)
Dipzy - What Do You Want
Nico Stojan, Jaw, Doctor Dru - Blue Hour (Doctor Dru Remix)
Sasha Virus - My House (Original Mix)
Paolo Solo - Last Fuss (Original Mix)
Javi Lopez - Last Swing
Todd Terry - Break Down (Extended Mix)
Simone Cristini - Glory Town
Tenacious - Loopa (Original Mix)
Vic Yamamoto - MoonLight
Ridney - Chopped That Sucker in 10 (Original Mix)
Luca Donzelli - Good Wine Makes Good Blood
The Golden Boy - Razz (Extended Mix)
Acid Skys - Blueprint (Original Mix)
LaVelle Dupree - Still I Rise (Original Mix)
Antoine Teezier - Love Each Other (Original Mix)
Louie Corrales - Don't Waste My Time (Original Mix)
5prite - Anyway (Original Mix)
Cuartero - Abandonado
Beki M - I Feel That Love (Original Mix)
Marc Romboy - Byglia (Audiojack Remix)
Wax Worx - Awesome Force (Original Mix)
Fabian Haneke, Divine (NL) - I Love The Way (Extended Mix)
Hot Since 82 - Pound Your Soul (Sidney Charles Remix)
IAMLOPEZ, Pablo Leone - Naked (Original Mix)
Masch + Yuko - Nolens Volens (Original Mix)
Wild & Dann - Babaorum (Original Mix)
Lars Horton - Strange
Jay Lumen - Stage 1 (Original Mix)
KTGeorge - Come Close (Original Mix)
Hutchy - Wanted (Original Mix)
Tube & Berger, Ante Perry - In the Shadows (Joeski Remix)
D.Noriega - D.Lights (Original Mix)
Danila - Dancin
La Tribu
Hybrid Theory - Get Wild (Original Mix)
Huxley, Ron Carroll - Work
Joe Brunning vs. Eats Everything (Ft. DAJAE) - The Tribute of Positive Vibes (DJ House Shadow Remix)
Mr. Kavalicious - Talking About (Original Mix)
Ismar Vehabovic - Never Sleep
Brokenears - Believe In Me (Extended Mix)
Eddie Amador - Rise (Deep Dish Vs. Eddie Amador Mix)
Oliver Schories - Relief (Gorge Remix)
Carlo Marani - George at the Club (Original Mix)
Dj Madskillz - Liquid Air (Original Mix)
Basement Jaxx - Jump N Shout (Erik Hagleton Remix)
James Organ, Géorgia Cecile - Addict
DMX - X Gon Give It To Ya (Dirty)
Patrick Hero feat. Stevan Lloyd - Running (Monococ Remix)
Jay Lumen - Bop Doo (Original)
Juliet Sikora - Keep On Fire (Original Mix)
Benny Royal - Murder Sound (Original Mix)
Simone Burrini - Cotton (Original Mix)
La Fleur - Flowerhead (Dana Ruh Remix)
Random Soul - Mr Dynamite (Withus Remix)
Tim Green - Halftone (Avatism Remix)
Andrew&Cole - Dancer (Original Mix)
DJ Jonny Law - C'mon (Original Mix)
Jon Flores - Music is the answer
Piero Scratch - WFU (Original Mix)
Tyler Coey - More Like This (Extended Mix)
David Aurel - Back Again (Original Mix)
Chocolate Puma & Mike Cervello - You Are My Life (Tony Romera Remix)
Roi Okev - Run Giorgio Run (Original Mix)
Jon Flores - Maxicosi (Original Mix)
Betoko - Solarium (Original Mix)
Victor Alarcon - Acid Groove (Original Mix)
State Unknown - Dirty Habits (Dolly Rockers Remix)
Hangin' Out With Charlie - CamelPhat (Original Mix)
Louden - Refracted
Little by Little - A Little Lost In Space (Original Mix)
Riva Starr - I Believe In You (Original Mix)
Smootrab - Trumpeted (Original Mix)
Paul Sirrell - Dub Number 6 (Original Mix)
Jean Bacarreza, Vanilla Ace - So Na Perc (Original Mix)
The Deepshakerz - Diggin'Down (Original Mix)
Roter, Lewis - Shaker (Original Mix)
The Sahoo Conection - Run Away (Original Mix)
Lewis Tala - Higher (Extended Mix)
James Talk - Amy's Groove (Original Mix)
Francesco Dinoia - Train (Original Mix)
Gianni Ruocco - Pum Pum Pum (Original Mix)
Tucci - Paranoice (Original Mix)
Waitz - On & On (Original Mix)
Dave Qri - Out of Tosca (Gabriel Slick Remix)
Bunce - Going Underground (Original Mix)
Sem Thomasson - Push & Pull (Extended House Party Mix)
Luca Bisori - World Today
Josh Butler - Addis (Original Mix)
Taran & Lomov - Aerobic (Original Mix)
Truce - Da Vinci (Original Mix)