Niko Freij - Big Booty (Original Mix)
Harry Romero - Drop Killa (Extended Mix)
Sovax - Turn Off The Lights (Original Mix)
Jowe X - The Beat Is My Drug 2014 (Original Mix)
Deeplomatik - 1St Lesson (Original Mix)
Oscar L - Tokio Groove (Original 12 Inch Mix)
Piracy (Stefano Noferini Remix)
Paul Sparkes - Early Tech (Original Mix)
Martinez & Quadelli - Beat Down (Original Mix)
Djey Piko - Yeah (Original Mix)
Stefano Crabuzza - My House (Original Mix)
Audiojack - Machine Code
Jochem Hamerling - Zipperr
Alex M (Italy) - Supernatural (Who Else Vocal Mix)
Alex Zamm - el Bosque (Original Mix)
Paolo Mojo, Newbie Nerdz - Micioux (Original Mix)
Alex Marttin - Body Like (Klaus Keller Remix)
Man with Soul (feat. Max Linen)
Jhonsson - Lost in Mogana
Chocolate Puma, Mike Cervello, Nightlapse - You Are My Life (Nightlapse Extended Remix)
Chedey Garcia - This Is Acid
Louder Than Words - Life on Mars
Don Pelojo - Da Body (Original Mix)
Stanny Abram - Feel Crazy (Original Mix)
Montel, Kevin Saunderson - Station of the Groove (Original Mix)
Christian Nielsen - Slanguage (Original)
Eddie Amador & Dany Cohiba - Black Bull (Marco Bruzzano Remix)
Electronic Youth - Gotta Be
Charles Ramirez - Rock the Party
Sandroo - You Never Just Listen To Me (Original Mix)
Harry Romero - Magma (Original)
Grenno - Bone Siren (Original Mix)
Yousef - Santiago (Original Mix)
Roland De Saint - Pivotal
Fritz & Lang - I Need Space (Dan Beaumont's Pumpathon Dub)
Max Kernmayer - Ma Bassline (Original Mix)
Alessandro Arbola - Sexy (Extended Mix)
Majesty - The Reefa (Original Mix)
Stefano Mango, DJ Vitto - Bar Funk (Original Mix)
Marc Spence - They Wanna (Original Mix)
Space Motion - Feel My Body (Extended Mix)
Supernova - Rock The Disco (Original Mix)
Audio kode - Isolation Control (Original Mix)
House Under The Moon - Direct Hit (Oliver Schmitz & Micah Sherman Remix)
Danny Howard - Two Three One (Marcellus Wallace & Dub Healy 234 Remix)
Krawall - Feel The Balance (Original Mix)
Lupe Fuentes - Wepa (Original Mix)
Mirco Caruso - Sometimes
Carlos Kinn - Kaleidoscope (Original Mix)
Dan Berkson, James What, Qzen - Worship (Dana Ruh Remix)
Jerome Sydenham - Blacksmith (Original)
Tricky - How's Your Life (Huxley Remix)
Nicola Assi - Meet the Budda (Original Mix)
Mr. Danny, Tonet Marza, Priscila Due - Imagine (Sergi Moreno, Jossy C, Vincent McFly Remix).wmv
Ayrton Lorenzo - Do This
Kickbugs - The Vibe (Original Mix)
Damir Pushkar - Pina Colada (Stanny Abram Remix)
Jo Crimaldi - My Job (Original Mix)
Branzei - I Can (Original Mix)
Dance On
David Caetano - Dont Stop
12 Stories - Showtime (Original Mix)
Gulivert - Time To Play (Original Mix)
Mat.Theo - Signals - Volume 1 (Original Mix)
David Keno - Cold Sweat (Original Mix)
Robiin - Break It (Original Mix)
Daniel Stefanik - Deep Inside (Andrea Oliva Remix)
Tim Le Funk - Turn Upside Down (Stanny Abram Remix)
Leftwing & Kody - Go Back (Original Mix)
Chus & Ceballos, DJ Chus, Pablo Ceballos - Afrika (Marco Lys Remix)
The Deepshakerz - What People Say (Original Mix)
Angelo Scalici - Gonna Be Like (Original Mix)
Ciszak - Triple X
Jose Ferrando - Densing (Original Mix)
Victor Zala - Some Time (Original Mix)
Joy Marquez - Fresh Night (Original Mix)
Franky Rizardo - Work It To The Bone
Kuestenklatsch - Play Around (Original mix)
Simone Vitullo - I'll Be Right
Jowe X - Hit Me Strong
F-Projekt - About That Time
Mark Maxwell - Dance (Extended Mix)
Perr0 - Fuse (Original Mix)
Gorge - Nayuma (Original Mix)
Enzo Sorrentino - Pistacchio
HP Vince, Chuck Roberts - Jack Had A Groove (Old School Mix)
Erick Morillo, Audio Bullys - Break Down The Doors (Danny Howard Extended Remix)
RanchaTek - Islas Balearas (Original Mix)
Ain't No Fun
Luca Bisori - Amazing Church (Original Mix)
Torren Foot - More Life (Extended Mix)
John Summit - Make Me Feel (Original Mix)
Someguy - Dancefloor (Club Mix)
Darius Syrossian - Disko Drop (Original Mix)
Luca Citoli - Desert Storm (Sexy Tribe Mix)
No Requests - Monsters (Original Mix)
Daniel Muscas - Flow (Original Mix)
Thomas Newson - The Worker (Extended Mix)
Phari - Honey (Original Mix)
Moodyboy - To The Beat (Original Mix)
Morena (Original Mix)
Pawas - Adana
Arkay - Lovin' Your Sound (Kyle Watson Remix)
KI Creighton - Nocturnal (Original Mix)
Deeplomatik - Lay Low (Original Mix)
Dennis Quin - So Far (Original Mix)
Jowe X - Supacrazy (Original Mix)
Sharam Jey, Andruss, Dewitt Sound - Right Back (Extended Mix)
Sllash & Doppe - Puff Daddy (Original Mix)
Versus - 1988 (Original Mix)
Rebel Town
Sascha Sonido - Mando Dio
Beki M - Alright (Original Mix)
Majesty - Mike Larry
Jorge Montia & Muzikfabrik - Spaingary (Jörgensen Remix)
Andrea Fiusco - Power In My Hands feat. Maky Dan (Official Video)
Funkerman - Speed Up (Menesix Remix)
Sound Process - I'm Your Crisis (Original Mix)
Go Freek - Love Is the Weapon (Cut Snake Remix)
Illyus & Barrientos - So Serious
Illyus & Barrientos - So Serious (Original Mix)
Brown Sneakers - Preacher (Original Mix)
Franky Rizardo - Rave Machine
Siege - Forget (Extended Mix)
Monoky - Let's Do It (Original Mix)
Re.You - Delusion
Cocktail (BSJ The Black Legend Remix Radio edit)
Mon amour (Instrumental Mix)
Breaking Toys - Spin This Record (Original Mix)
Supernova - La Rambla (David Keno Remix)
Horatio - Redflower (Original Mix)
Smooth Dancer (Extended Mix)
Supernova - Suite 58 (Tiger Stripes Remix)
Paul C & Paolo Martini - Striptease
84Bit - Bombinho (Original Mix)
Huxley & Skapes - Say Nothing
Alber Kleyn - Blackout (Original Mix)
Melé 'The Latin Track'
Emma Ruggers - Minimal Sensation (Original Mix)
Renaud Genton - What Is House (Original Mix)
Are You Joely, NightFunk - Excuse Me (Extended Mix)
Skayem - Origins
K & K - Feelin High
Chris IDH - About You (Original Mix)
Wehbba, Antonio Eudi - The Real Thing (Original Mix)
Alan Fraze - Hydrogen
Dany Deep - The Lockdown (Original Mix)
Jaimy - Dirty People (Instrumental)
Ramon Tapia - Talk To Me
PushPull - Cowboys Dream (Original Mix)
Sebastien Leger - Waves of Life (Original Mix)
How We Do (feat. Mr. V) (Raffa Fl Re Edit)
Ocean Roulette - Froze Up
Blacktron - 32 KM (Stefano Noferini Vibe Mix)
Emlyn BPM - Bap Boo (Original Mix)
Anthony Attalla - How Far (Gene Farris Big One Remix)
Agei - Afrifunk
Mihalis Safras - Eva (Wehbba Remix)
DJ Christopher - Phantom (Original Mix)
Dark Matter
Will Gold, Etienne Ozborne, Celeda - The Underground (Original Mix)
Right On - Wir wissen
Afro Moon (Andrew Meller Remix)
JP Chronic, Gramma Funk - Funky Shit (Gruia Remix)
Oliver Dollar, Gene Farris - Sampling (Christian Nielsen Remix)
Chuck Daniels - What! (Original)
Phonista - Calling (Dan Rubell Remix)
Ruben Zurita - Monedita de Oro (Original Mix)
Joop (Original Mix)
ZDS - Do You Like
Joseph Vier, Joze, Dark Saw - Gu (Original Mix)
Kyle Watson - Oh the No (Original Mix)
Paolo Solo - Divine (Again Mix)
2 Sides of Soul - Deep Town (Original Mix) - LAPSUSMUSIC_CUT
Federico Ambrosi - More Power (Original Mix)
Mekkawy - Ven Pa'Ca (The Deepshakerz Edit)
Deeper Than L - Doin Bits (Original Mix)
Prune Flat - Not To Do (Original Mix)
Redo Desyo - Break It Down (Original Mix)
Musique Came On (Main Mix)
5prite - Breakin (Original Mix)
Zappe - Larry's Exotic Blend (Joeski's Ruff Disco Mix)
Stefano Parenti - Party People (Original Mix)
Daniel Levak - Bass Maker (Original Mix)
ANOTR - Futur (Original Mix)
Haus On Fire - Insane Love (Hauswerks Extended Remix)
Maliki - Disco Kaiser (Original Mix)
CJ Jeff - Insanity (Original Mix)
Luigi Rocca - High Again
Joy Marquez - Candela 2018 (Original Mix)
Luca Grossi - On And On (Original Mix)
Ultra PoP - Jungle (Original Mix)
Yade - Feel Like (Michael Quadelli Remix)
HR & SKI - AVEJA
Oliver Schmitz, Micah Sherman - Chamber (Original Mix)
Yousef - For One Sin (Original Mix)
Matt Caseli - Dance Together (Original Mix)
Ann Nesby - So Much Joy (Alaia & Gallo Extended Remix)
Jon Flores - Lets Go
Damir Pushkar - Yellow Bus (Original Mix)
DC Dubz - Yaiza
Espinal & Nova - Rimshot (Extended Mix)
Christian Cambas - We Found a World (Stefano Noferini Remix)
Rick Silva - Shout & Dance (Original Mix)
Fernando Curto - Jack Move (Original Mix)
Ekoboy - After All
Stefano Noferini - Dabadu (Original)
Tim Cullen - Take This (Extended Mix)
Shiba San - Acid Juice (Original Mix)
Luca Doobie - Be The Rainbow (Original Mix)
Ricky Sierra - New Power (Original Mix)
Hotspot & Komaroff - Get Wild (Original Mix)
JCMB, D-MICE - Set My Body (Original Mix)
Rovito & Nolan - Babylon
Paolo Solo - Divine (Original Mix)
Ludo Lacoste - When You Were Down (Extended Mix)
Melé - Groove La Afrika
Jay Blakk - There's No Formula For Love (Supernova Remix)
Brett Johnson - Breathe
NightFunk, Are You Joely - Excuse Me Feat. Joely (Extended Mix)
Bontan - State Of Mind (Original Mix) [Suara]
Solardo - Squeeze (Original Mix)
Andrea Marchesini - Dance Like Children (Original Mix)
No Stress (Original Mix)
Stanny Abram - Goin Crazy (Original Mix)
Relow - The Best Choice
Modegroove - El Recuerdo (Original Mix)
Reblok - Centerfold (Original Mix)
31.07.2020 MARCO ANZALONE - BLUE STRAWBERRY GUEST MIX
Stanny Abram - Pallaqua
Nadia - Roller (Original Mix)
Toni Vilchez - Japan Flute (79 Mix)
Sixteenth Pulse - Internalised
Purple Disco Machine - No Lips (Veerus & Maxie Devine Remix)
James Curd, Nah Man - Whisper (Original Mix)
Maceira (Live Edit)
MBNN - Uncertain (Original Mix)
JCMB & D-MICE, JCMB, D-MICE - You Know (Original Mix)
Alvaro R, Joe Red - Chinchilla (Original Mix) [TECH HOUSE]
Tim Cullen, Evil Twin - Hands Out (Original Mix)
Quadrumana - Vamonos!
John Summit, Dead Space - Guest List (Original Mix)
Junior Sanchez - Everyday (Original Mix)
KI Creighton - My Beat
Boom Shake (Original Version)
Hominum - Away (Original Mix)
Karlos Cheadle - Full Boar (Original Mix)
Kadenza - The Love (Original Mix)
Lil'M & Jok - Eyes On Me (Original Mix)
Jon Flores - Keep on Lifting (Ibiza 2k13 Reworked Mix)
Space Ibiza On Tour @ GRACE NY (ROOM MATE) on Saturday September 10th!
Freejak, Josh Hunter - Keep This Thing Rolling (Original Mix)
Stanny Abram - Spin That Wheel (Original Mix)
Dj Csemak - Once Again Back (No Vocal Mix)
Felipe Michelin - My Mind (Original Mix)
Ray MD - Yemaya (Luis Pitti Remix)
Joeski - Take You Higher (Original Mix)
Ray Manteca - Mayamero (Mojitos Mix)
Ricardo Farhat - Recess (Original Mix)
Edu Natored - Voodoo Sex
Titan Road - Running Back (Original Version)
James Fergus - Bring It (Original Mix)
Dani Vars - Tactical Rhythm
Luke Stanger - Twisted (Original Mix)
Jay Lumen - Project 94 (Original Mix)
Flashmob - Days to Nights (Feat. Anna Wall)
Maximiljan - All the Way
Chris Child, The Concept - Lie (Original Mix)
Jay Mexx - Hold My Hands (Original Mix)
Alex Denne Josep Arrom Ibiza Sergi Moreno  Borja Cubes Remix
Lee Walker - Rock Climber (Original Mix)
The S-Men - Samba Do Noite (DJ Sneak Remix)
Marco Lys - I Heat Up (Extended Mix)
SP1DER - Poison (Original Mix)
CLS - Can You Feel It (Prok & Fitch Remix)
Fabbie - M81 (Original Mix)
Gorge - Way Back (Original Mix)
Greg Gelis - Let Me Tell You (Handzoff & Emanuele Esposito Remix)
Emolw - Shake That
Matto - End It Loud (Original Mix)
Stefano Ranieri - Less Talk (Original Mix)
Spin That Wheel (Command Your Soul Mix)
Chus & Ceballos, Carlos Manaca, DJ Chus, Pablo Ceballos - The Strong Rhythm (German Brigante Remix)
Dakar - See You Work (Original Mix)
Alan Fraze - Turning a Blind Eye (Alex Roque Remix)
Eddie Krystal - Mayan Groove (Original Mix)
Casual Villain - Up To No Good (Original Mix)
Lewis Beck - Joke's On You (Original Mix)
Mike Vale - Just A Friend (Extended Mix)
Dj Lugo - Knowing Your Mind
System2 - Sunscreen
TouchTalk - People Come (Original Mix)
Kovyazin D - The Iron Jack
Alonso Villari - Pitch Loved
Ki Creighton - My Beat (Original Mix)
Paul Ursin - Get Down the Ground
Raul Facio - Loco (RanchaTek Remix)
Motez - Roll Out (Huxley Remix)
Technasia - I Am Somebody (Original Mix)
Adrian Groove - Gimme Hot (Original Mix)
Ninetoes - Parole (Extended Version)
Stanny Abram - Pumulani (Original Mix)
Reblok - They Just Talkin' (Original Mix)
Groovebox - Reflected
Melé - Esperanza (Extended Mix)
DoomWork - This! (Mihalis Safras WMC Remix)
RanchaTek, Stanny Abram - On The Streets (Original Mix)
Sven Tasnadi, Gjeazon - My Groove (Doorly Remix)
Marco Marset - No Sleep (Original Mix)
Deeper Than L - Listen For It (Original Mix)
Kike Henriquez - Back To The Stereo (Original Mix)
Dj Csemak - Underway
Bad Boy Orchestra - Bomba (Angel Manuel Remix)
Tuff London - Se7ven (Original Mix)
Technasia - I Am Somebody
Joy Marquez, John Corba, Hot Tuneik - Touch Me (Original Tech Mix)
GAWP - Blocker
Danniel Selfmade - Only Just (Original Mix)
Samu.l - Lundy (Original Mix)
Jesus Di Mata - The Comeback (Original Mix)
Nico Balducci - Adesso (Original Mix)
Alex Twitchy - The Ground (Original Mix)
Mihalis Safras  ft Noidoi - chicas latinas
Rich Wakley - Behind The Mask
Kaiserdisco - Silfide
Riva Starr - Dippin' Side (Joseph Capriati Remix)
CLESENT - Break (Extended Mix)
I'm The Creator (Original Mix)
Florian Picasso - Muki (Original Club Mix)
Andrea Maggino, Marco Santoro - Be Strong (Brokenears Mix)
RanchaTek, Stanny Abram, Dos Padres - La Boriqua (Original Mix)
Nausikke - Believe Me
Ricardo Diiaz - No Soul (Original Mix)
El Gran Cantante - Albert Aponte, Chris Groovejey (Original Mix)
Matteo DiMarr - Blower feat. Dashka
Alaia & Gallo - Sunday Morning (Original Mix)
Mad Morello - Niagara (Original Mix)
AJ Christou & Caleb Calloway - Sweet Senses (Stacey Pullen Remix)
Cojones (Original Mix)
Moreno Pezzolato - Rushing (Original mix)
Brandon Caballero - In the Fill
Tocadisco feat Roland Clark - Phoenix (Original Club Mix)
David Lowe - The Conspiracy (Original Mix)
2 Sides Of Soul - Purity (S-Man Primitive Remix)
Richard Dinsdale, Tim Cullen - It's You Again (Luigi Rocca Remix)
Nils Ohrmann - Le Funk Fatale (feat. Karas Day) (Jan Driver Remix)
Jessie Andrews - Grind
Gabriel Ben - Dont Bother Me (Original Mix)
Santo Arrosa - Tamo Manajo (David Kinnard & Pappu Remix)
John Dish, Allen Wish - De Ha
Mark Dale - Nocturnal (Original Mix)
Volkoder - Big Ear (Original Mix)
Beki M - Power (Original Mix)
Phat Eric - Atmo (Original Mix)
Folgatto - Show Me (Original Mix)
Mendo - Diva (Original Mix)
Level Groove - Mute (Original Mix)
Coso - I Wanna Rock (Extended Mix)
Dipzy - What Do You Want (Steady Rock Remix)
Bohemien - Jack Them (Original Mix)
Jacopo Ferrari - Downtown (Extended Mix)
Espinal & Nova - Merry Go Round (Original Mix)
ABASAF - LP Free (Midnight City Remix)
Our Anthem - My Soul (Kevin McKay Extended Mix)
Steve Angello -  Knas ( Original Mix )
Rick Silva - Raving Acid (Original Mix)
Touch - Fringe (Original Mix)
Francesca Lombardo - Spondylus
Dom Townsend - People In The Ghetto (Original Mix)
Inside My Mind (Original Mix)
Pete Zorba - The Valley (Original Mix)
Kalpazan (Original Mix)
Amorhouse - My Body
Electrik Cat - WTF (Original Mix)
Vangelis Kostoxenakis - Take Your Shirt Off (Original Mix)
Good Loving
Joe Red - Satisfact
Jesus Nava - House Transitions (Original Mix)
Biscits, MITA (BR) - Tribalism (Extended Mix)
RanchaTek - Pump It (Original Mix)
Stanny Abram - It's Like That (Original Mix)
Joeski - All by Myself (Andrea Oliva Remix)
Mario Ochoa - Stingray
Guti - Desidia (Nic Fanciulli Remix)
Gary Caos - Mammals (Original Mix)
LucaJLove - People (Alex Twitchy Remix)
Roof Rats - Get in On (Original Mix)
Electronic Youth - E-Tronix (Original Mix)
John Spinosa, Uch, Morsy - Miami Calling (Original Mix)
Servante - Frisky (Original Mix)
Silver Ivanov - Hang Out (Original Mix)
Space Motion, Frank'o Moiraghi, Kevin McKay - Feel My Body (Extended Mix)
Sharam Jey - Your Body (Paolo Martini Remix)
Mighty Dub Katz - Just Another Groove (Doorly Remix)
Sacha Robotti, Look Like - Dropout
Leonardo Rosa - Pump It Up
Tim Andresen - Get Da Funk (Redondo Mix)
Yogoro (Version 3)
Catz 'N Dogz, ZENSOFLY, Maxville - Wave feat. ZENSOFLY & Maxville (Club Mix)
Javier Perez - El Despertar
Pulse Nation Project - My Tech Funky